border_size=1
usage=map

Gg     , Gg     , Gg     , Gg     , Gg     , Gg     , Gg     , Gg     , Gg     , Gg     , Gg     , Gg     , Gg     , Gg     , Gg     , Gg     , Gg     , Gg     , Gg     , Re^Gvs , Re^Gvs , Re^Gvs , Gs     , Gg     , Gs     , Gs     , Gs     , Gs     , Gg     , Gg     , Gg     , Re^Gvs , Re^Gvs , Re^Gvs , Gg     , Gg     , Gg     , Gg     , Gg     , Gs     , Gg     , Gg     , Gg     , Gg     , Gg     , Gg
Gg     , Gg     , Gg     , Gg     , Gg^Vh  , Gg     , Ss     , Gg     , Gg     , Gg     , Gg     , Gg     , Gs^Fp  , Gg^Vh  , Gg^Fp  , Gg     , Gg     , Gg     , Gg     , Gg     , Gg^Efm , Gg     , Gg     , Gg     , Gg     , Gs     , Gg     , Gg     , Gg^Vh  , Gg     , Gg^Fp  , Gg     , Gg     , Gg     , Gg     , Gg     , Gg     , Gg     , Gg     , Gg     , Gg     , Gg     , Gg     , Gg^Efm , Gs     , Gg
Gg     , Gg     , Gg     , Gg     , Gg     , Gg     , Gg     , Gg^Efm , Gg     , Gg     , Gg     , Gg     , Gs^Fp  , Gg^Fp  , Gs^Fp  , Gg     , Gg     , Gg     , Gs^Fp  , Gg^Vh  , Gs^Fp  , Gs^Fp  , Gg     , Gg     , Gg     , Gg     , Gg     , Gg^Efm , Gg     , Gs^Fp  , Gs^Fp  , Gg^Fp  , Gg     , Gg     , Gg     , Gg     , Gg     , Gs^Fp  , Gg     , Gg     , Gs     , Gs     , Gs^Es  , Gs     , Gs     , Gs
Gg     , Gg     , Gg     , Gg     , Gg     , Gg     , Gg     , Gg     , Gg     , Gg     , Gg     , Gg     , Gg     , Gg^Fp  , Gg     , Gg     , Gg^Es  , Gg     , Gs^Fp  , Gs^Fp  , Gs^Fp  , Gs^Fp  , Gs^Fp  , Gg     , Gg     , Gg^Efm , Gg     , Gg     , Gg     , Gs     , Gs     , Gs^Fp  , Gg     , Gg     , Gg     , Gs^Fp  , Gg     , Gg^Fp  , Gg     , Gg^Vh  , Gg     , Gs     , Gs     , Gs     , Gg^Vh  , Gs
Gs^Fp  , Gg     , Gg     , Gg^Es  , Gg^Es  , Gg     , Gg     , Gg     , Gg     , Gg     , Gg     , Gg     , Gg     , Gg     , Gg     , Gg     , Gg     , Gg     , Gg     , Gs^Fp  , Gll^Fp , Gs^Fp  , Ss     , Gg     , Gg^Efm , Gg     , Gg     , Gg     , Gg     , Gs     , Gg     , Gg     , Gg     , Gg^Efm , Gg     , Gs^Fp  , Gg     , Gg     , Gg     , Gg     , Gs^Fp  , Gs     , Gs     , Gs     , Gg     , Gg
Gs^Fp  , Gg     , Gs^Fp  , Gg     , Gs^Fp  , Ss     , Ss     , Gg     , Wwf    , Gg     , Gg     , Gg     , Gg     , Gg     , Gg     , Gg     , Gg^Efm , Gg     , Gg     , Gg     , Gg     , Ss     , Gg     , Gg     , Gg     , Gg     , Gg     , Gg     , Gg     , Gg     , Gg     , Gg^Efm , Gg     , Gg     , Gg     , Gg     , Gg     , Gg     , Gg     , Gg     , Ss     , Gs^Fp  , Gg     , Gg     , Gg     , Gg
Ww     , Gs^Fp  , Ss     , Gs^Fp  , Ww     , Ww     , Ww     , Ww     , Ww     , Gg     , Gg     , Gg     , Gg     , Gg     , Gg     , Gg     , Gg     , Gg     , Gg     , Gg^Es  , Gg     , Gg     , Gg     , Gg     , Gg     , Gg     , Gg     , Gg^Efm , Gg     , Gg     , Gg     , Gg     , Gs     , Gs     , Gs     , Gs     , Gs     , Gg^Efm , Gg     , Gg     , Gg     , Gg     , Gg     , Gg     , Gg     , Gg
Ww     , Ww     , Ww     , Ww     , Ww     , Ww     , Ww     , Ww     , Ww     , Ww     , Ss     , Gg     , Gg     , Gg^Vh  , Ss     , Gg     , Gg     , Gg     , Gg     , Gg     , Gg     , Gg     , Gg     , Gg     , Gg^Efm , Gg     , Gs     , Gg     , Gg     , Gg     , Gg     , Gg     , Gg^Vh  , Gs     , Gs     , Gs^Es  , Gs     , Gg     , Gg     , Gg     , Gg     , Gg     , Gg     , Gg     , Gg     , Gg
Ww     , Ww     , Ww     , Ww     , Ss     , Ww     , Wwf    , Ww     , Ww     , Ww     , Ww     , Ss     , Ss     , Ss     , Ss     , Gg     , Gg     , Ss     , Gg     , Ss     , Gg     , Gg     , Gg     , Gg     , Gg     , Gs     , Gs     , Gg     , Ss     , Ss     , Ss     , Ss     , Gg     , Gs     , Gs     , Gs     , Gs     , Gs     , Ss     , Gg     , Gg     , Gg     , Gg^Efm , Gg     , Gg     , Gg
Gs^Fp  , Ww^Ewl , Gs^Fp  , Ss     , Ww^Ewf , Ss     , Ss     , Ss     , Ww     , Ww     , Ww     , Ss     , Ww^Ewl , Ss     , Ww     , Ss     , Wwf^Es , Gg     , Ss     , Gs^Fp  , Ss^Vhs , Ss     , Ss     , Ss     , Gs     , Gg     , Gs     , Gs     , Wwf    , Ss     , Ww     , Wwf    , Ww     , Ss     , Ss     , Gg     , Ss     , Gs     , Ss     , Ss     , Gs^Fp  , Ss     , Gs^Fp  , Gg     , Ss     , Gg
Gs^Fp  , Ss     , Ss     , Ss     , Ss     , Ss     , Ss     , Ss     , Ss     , Ww     , Ww     , Ww     , Ww     , Ww     , Ww     , Ww     , Ww     , Ss     , Ss     , Ss     , Ss     , Ss     , Ss     , Ss     , Ss     , Ss     , Ss     , Ww     , Ww     , Ww     , Ww     , Ww     , Ww     , Ww     , Ww     , Ss     , Ss     , Gs^Fp  , Ss     , Gg^Vc  , Ss     , Ss     , Gs^Fp  , Ss     , Ss     , Ss
Ss     , Ss     , Gs^Fp  , Ss     , Ss     , Ss     , Gs^Fp  , Ss     , Rb     , Ww     , Ww     , Ss     , Ww     , Ww     , Ss     , Ww     , Ww     , Ss     , Ww     , Ww     , Ss     , Ss     , Ww     , Ss     , Ww     , Ss     , Ww     , Ww     , Ww     , Ww     , Ww     , Ww     , Ss     , Ww     , Ww     , Ss     , Ss     , Gs^Fp  , Ss     , Gs^Fp  , Ss     , Gll^Fp , Ss     , Ss     , Ss     , Ss
Gs^Fp  , Ss     , Ss     , Gs^Fp  , Ss     , Ss     , Ss     , Ss     , Gll    , Ss^Vm  , Ss     , Ww     , Ss     , Rb     , Ss     , Ww     , Ww     , Ww     , Ww     , Ww     , Ww     , Ww     , Wo     , Ww     , Ww     , Ww     , Ww     , Ww     , Ww     , Ss     , Ss     , Ss     , Ss     , Ww     , Ww     , Ww     , Ss     , Ss     , Gs     , Ss     , Ss     , Ss     , Ss     , Ss     , Gs     , Ss
Gs^Fp  , Gs^Fp  , Ss     , Gs^Fp  , Gs^Fp  , Ss     , Gs^Fp  , Ss     , Ss     , Ss     , Ss     , Ss     , Ss     , Re     , Gs     , Ss     , Ss     , Ww     , Ww     , Ww     , Ww     , Ww     , Ww     , Wo     , Ww^Ewf , Ss     , Ss     , Ss     , Ww^Ewf , Ww^Ewl , Ss     , Wwf    , Wwf    , Ww     , Ww     , Ww     , Ss     , Ss     , Ss     , Gs     , Ss     , Ss     , Ss     , Ss     , Ss     , Ss
Hh^Fp  , Ss     , Gg     , Gs^Fp  , Gg     , Gs^Fp  , Gg     , Ss     , Re     , Ss     , Ss     , Ww     , Ww     , Ss     , Ss     , Ss     , Ss     , Ss^Vm  , Ss     , Ss     , Ss     , Ss     , Ss     , Ww^Ewl , Ww^Ewl , Ss     , Ss     , Ss     , Ss     , Ss     , Ss     , Ss     , Wwf    , Ww     , Ww     , Ww     , Ww     , Ss     , Ss     , Wwf    , Ww     , Ww     , Ww     , Ss     , Ww     , Ww
Hh^Fp  , Hh^Fp  , Gs^Fp  , Gg     , Gs     , Gs^Fp  , Gs     , Re     , Ss     , Ss     , Gs^Fp  , Wwf    , Ww     , Ww     , Ss     , Ss     , Ss     , Ss     , Ss     , Ss     , Ss     , Ww^Ewl , Ss     , Ss     , Ss     , Ww     , Ss     , Gg^Efm , Ss     , Ss^Vhs , Ss     , Ss     , Ss     , Ss     , Ww     , Ww     , Ww     , Ss     , Ww     , Wwf    , Ww     , Ww     , Ww     , Ww     , Wo     , Wo
Hh^Fp  , Hh     , Gs^Fp  , Gs^Fp  , Gg     , Gs     , Gs     , Gg     , Gg     , Gs^Fp  , Gs^Fp  , Ss     , Ww     , Ww     , Wwf    , Ss     , Ww     , Ss     , Ww     , Wwf    , Ww     , Ss     , Ss     , Ss     , Gs^Fp  , Ss     , Ss     , Ss     , Gs^Fp  , Ss     , Ss     , Ss     , Gs     , Ss     , Ww     , Ww     , Wwf    , Ww     , Ww     , Ww     , Wo     , Ww     , Wwf    , Ww     , Ww     , Ww
Hh^Fp  , Hh^Fp  , Gg^Es  , Gs^Fp  , Gg     , Gs     , Gs^Fp  , Re     , Gg     , Gg     , Gs     , Gs^Fp  , Ss     , Gs^Fp  , Gs^Fp  , Ww     , Wwf    , Ww     , Wwf    , Ww     , Ss     , Gs^Fp  , Ss     , Ss     , Gs^Vht , Gs     , Gs     , Gs^Fp  , Ss     , Gs^Fp  , Ss     , Gs     , Gs     , Ss     , Ss^Vm  , Ww     , Wwf    , Ss     , Ww     , Ww     , Ww     , Ww     , Ss     , Ww     , Ss     , Ss
Hh     , Hh^Fp  , Gg     , Gs^Fp  , Gg     , Gg     , Gs     , Re     , Gs^Fp  , Gs^Es  , Gs^Fp  , Gs^Fp  , Gs^Fp  , Ss^Fp  , Gs^Fp  , Wwf    , Ss     , Wwf^Es , Ss     , Ss     , Gs^Fp  , Gs^Fp  , Ss     , Ss     , Ss     , Gg     , Gg     , Gg     , Ss     , Gs^Fp  , Ss     , Ss     , Ss     , Rb     , Ss     , Ww     , Ss     , Wwf    , Wwf^Es , Ww     , Re     , Ss     , Ss     , Gs^Fp  , Ss     , Ss
Gs^Fp  , Hh^Fp  , Gs^Fp  , Ss     , Ss     , Gs     , Gs     , Gg     , Gg     , Gs^Fp  , Gs^Vht , Gs^Fp  , Gs^Fp  , Gs^Fp  , Ss     , Ss     , Ss     , Ss     , Ss     , Ss     , Re     , Re     , Ss     , Ss     , Ss     , Ss     , Ss     , Ss     , Ww     , Ss     , Ss     , Rb     , Ss     , Ss     , Wwf    , Ss     , Ww     , Wwf    , Ww     , Ss     , Gs     , Gs     , Ss^Vhs , Ss     , Ss     , Ss
Gs     , Gs^Fp  , Ss     , Ss     , Ss     , Ss     , Ss     , Ss     , Ss     , Re     , Re     , Ss     , Ss     , Ss     , Ww     , Ss     , Ss     , Ss^Vhs , Ss     , Ss     , Ss     , Ss     , Ss     , Ss     , Ss     , Ww     , Ss     , Ss     , Ss     , Ww     , Ss     , Rb     , Ss     , Wwf    , Ww     , Ww     , Ww     , Ww     , Ww     , Gs     , Gs     , Ss     , Ss     , Ss     , Ss     , Ss
Ss     , Ss     , Ss     , Ss     , Ww     , Ss     , Ww     , Ss     , Ww     , Ss     , Ss     , Ss     , Ss     , Ww     , Ww     , Ss     , Ss     , Ss     , Ss     , Ss     , Ww     , Ww     , Ww     , Ss     , Ss     , Ss     , Ss     , Ss     , Gs     , Ss     , Ss     , Ss     , Ww     , Ww     , Ww     , Wwf    , Gg     , Ww     , Ss     , Ss     , Gs^Fp  , Ss     , Gs     , Gs     , Ss     , Ss
Ss     , Ss     , Ss     , Ss     , Ss     , Ww     , Ww     , Ss     , Ss     , Ss     , Rb     , Ss     , Ss     , Gs^Fp  , Ss     , Ss     , Ss     , Ss     , Ww     , Ww     , Ww     , Ss     , Ww     , Ss     , Ww     , Ss     , Ss     , Ss     , Ss     , Ss     , Ss     , Wwf    , Ww     , Ww     , Gs^Fp  , Gg^Fp  , Gs^Fp  , Gs^Fp  , Gs^Fp  , Ss     , Ss     , Ss     , Gs     , Gs     , Ss     , Ss
Ss     , Ss     , Gs^Fp  , Ss     , Ss     , Ss     , Ww     , Ww     , Ss     , Ss     , Rb     , Gs^Fp  , Gs^Fp  , Ss     , Ss     , Ss     , Ss     , Ss     , Ww     , Ww     , Ww     , Ww     , Ww     , Ww     , Ss     , Ww     , Ww     , Ss     , Ww     , Ss     , Ww     , Ww     , Ww     , Ss     , Ss     , Gs^Fp  , Gs^Fp  , Gs^Fp  , Ss     , Ss     , Gs^Fp  , Ss     , Ss     , Ss     , Ss     , Ss
Ss     , Gs^Fp  , Gs^Fp  , Ss     , Gs^Fp  , Ww     , Ss     , Ww     , Ss     , Ss     , Ss     , Gs^Fp  , Ss     , Ss     , Ss     , Ss     , Ww     , Ww     , Ww^Ewl , Ss     , Ss     , Ww     , Ss     , Ss     , Ss     , Ww     , Ss     , Ww     , Ss     , Ww     , Ww     , Ww     , Ss     , Ss     , Ss     , Ss     , Gs^Fp  , Ss     , Ss     , Gs^Fp  , Ss     , Ss     , Ss^Vhs , Ss     , Ss     , Ss
Gs^Fp  , Gs^Fp  , Gs^Fp  , Gs^Fp  , Ss     , Ss     , Gs^Fp  , Ss     , Ss     , Ss     , Ss     , Rb     , Rb     , Ss     , Ss     , Ss     , Ww     , Ss     , Ww^Ewf , Ss     , Ss     , Ss     , Ss     , Ss     , Ss     , Ss     , Ss     , Ss^Vm  , Ss     , Ww^Ewl , Ss     , Ss     , Ss     , Ss     , Ss     , Ss     , Ss     , Ss     , Ss     , Ss     , Chs    , Ss     , Ss     , Ss     , Ss     , Ss
Gs^Fp  , Gs^Fp  , Gs^Fp  , Gs^Fp  , Gs^Fp  , Ss     , Ss     , Ss     , Ss     , Ss^Vhs , Ss     , Ss     , Rb     , Ss     , Ww     , Ww     , Ww     , Ww^Ewl , Ss     , Ss     , Ss     , Ss     , Gg     , Ss     , Ss     , Ss     , Ss     , Ss     , Ss     , Ss     , Ss     , Ss     , Ss     , Hh     , Hh     , Ss     , Ss     , Ss     , Ss     , Chs    , 2 Khs  , Chs    , Ss     , Ss     , Ss     , Ss
Gs^Fp  , Gs^Fp  , Ss     , Gs^Fp  , Ss     , Gs^Fp  , Ss     , Gs^Fp  , Ss     , Ss     , Ss     , Ss     , Chs    , Ss     , Ww     , Ww     , Ww     , Wwf^Ewl, Ss     , Ss     , Ss     , Ss     , Gs^Fp  , Ss     , Gg     , Ss     , Gs^Fp  , Gs^Fp  , Gs^Fp  , Ss     , Ss     , Ss     , Hh     , Hh     , Ss     , Ss     , Gs^Fp  , Ss     , Ss     , Chs    , Chw    , Chw^Ewl, Ww     , Ww     , Ww     , Ww
Gs^Fp  , Gs^Fp  , Ss     , Gll^Fp , Gs^Fp  , Gs^Fp  , Ss     , Ss     , Gs^Fp  , Ss     , Ss     , Chs    , 1 Khs  , Chw    , Ss     , Ww     , Ww     , Ss     , Ss     , Ss     , Ss     , Ss     , Ss     , Ss     , Gs^Fp  , Gs^Fp  , Gg     , Gg     , Gg     , Gs^Fp  , Gs^Fp  , Ss     , Ss     , Ss     , Ss     , Ss     , Ss     , Ss     , Ww     , Ss     , Ww     , Ww     , Wo     , Ww     , Wo     , Ww
Gs^Fp  , Gs^Fp  , Gs     , Gll^Fp , Ss^Vhs , Ss     , Gs^Fp  , Ss     , Ss     , Ss     , Ss     , Chs    , Chs    , Chw    , Ww     , Ww     , Ww     , Ww     , Ww     , Ss     , Ss     , Ss     , Ss     , Gs^Fp  , Ss     , Gg     , Gs^Fp  , Gs^Fp  , Gg^Vc  , Gs^Fp  , Gs^Fp  , Gs^Fp  , Ss     , Ss     , Ss     , Ss     , Ss     , Ss^Vm  , Ww     , Ww     , Ww     , Wo     , Wo     , Wo     , Ww     , Ww
Gs^Fp  , Gs^Fp  , Gs^Fp  , Ss     , Gs^Fp  , Gs^Fp  , Gs^Fp  , Ss     , Ss^Fp  , Ss     , Ss     , Ss     , Ss     , Ss     , Ss     , Ss     , Ss     , Ww     , Ww     , Ss     , Ss     , Ss^Vhs , Ss     , Ss     , Ss     , Ss     , Ss     , Gs^Fp  , Gs^Fp  , Gs^Fp  , Gs^Fp  , Gs^Fp  , Gll^Fp , Gs^Fp  , Gg     , Ss     , Ss     , Ss     , Gs^Fp  , Ww^Ewl , Ss     , Ww     , Ww     , Ww     , Ww     , Ss
Gs^Fp  , Gs^Fp  , Ss     , Ss     , Gs^Fp  , Gs^Fp  , Gs^Fp  , Gs^Fp  , Ss^Fp  , Ss     , Ss     , Ss^Vhs , Ss     , Rb     , Ss     , Ss     , Ss     , Ww     , Ww     , Ww     , Ss     , Ss     , Ss     , Ss     , Gs     , Ss     , Ss     , Ss     , Hh^Fp  , Hh^Fp  , Hh^Fp  , Gs^Fp  , Ss     , Gs     , Gs^Fp  , Gs     , Gs     , Gs^Fp  , Gs^Fp  , Ss     , Ss     , Ss     , Ss     , Ss     , Ss     , Ww
Gs^Fp  , Gs^Fp  , Ss     , Gs^Fp  , Gs^Fp  , Gs     , Gs     , Gs^Fp  , Gs^Fp  , Ss^Fp  , Ss     , Ss     , Rb     , Rb     , Ss     , Ss     , Ss     , Ss     , Ss     , Ww     , Ww     , Ss     , Ss     , Ss     , Gs     , Gs     , Ss     , Ss     , Gs^Fp  , Hh^Fp  , Hh^Fp  , Hh^Fp  , Gs^Fp  , Ss     , Ss     , Gs^Fp  , Ss     , Ss     , Ss     , Gs^Fp  , Ss     , Gs^Fp  , Gs^Fp  , Ss     , Ss     , Ss
Gs^Fp  , Gs     , Gs^Fp  , Gs^Fp  , Ss     , Gs^Fp  , Gs^Fp  , Ss     , Ss     , Gs^Fp  , Ss     , Ss     , Ss     , Ss     , Ss     , Ss     , Ss     , Ss     , Ww     , Ww     , Ww     , Ww     , Ss     , Ss     , Ss     , Ss     , Ss     , Ss     , Hh^Fp  , Hh^Fp  , Hh     , Hh^Fp  , Hh^Fp  , Ss     , Gs^Fp  , Gs^Fp  , Gs^Fp  , Ss     , Ss     , Ss     , Ss     , Ss     , Ss     , Ss     , Ss     , Ss
