border_size=1
usage=map

Uu     , Uu     , Ur     , Uu     , Uu     , Uu     , Qxu    , Uu     , Uu     , Uu^Vud , Uu     , Uu     , Qxu    , Qxu    , Qxu    , Xu     , Qxu    , Qxu    , Qxu    , Xu     , Xu     , Xu     , Wwy    , Wwy    , Xu     , Qxu    , Qxu    , Xu     , Xu     , Xu     , Xu     , Xu     , Xu     , Xu     , Xu     , Xu     , Xu     , Xu     , Xu     , Xu     , Xu     , Xu     , Xu     , Xu     , Xu     , Xu
Xu     , Uu     , Uu     , Ur     , Ur     , Uu^Uf  , Qxu    , Qxu    , Qxu    , Uu     , Qxu    , Qxu    , Xu     , Qxu    , Xu     , Qxu    , Xu     , Qxu    , Qxu    , Xu     , Qxu    , Qxu    , Uu     , Wwy    , Qxu    , Qxu    , Qxu    , Xu     , Xu     , Xu     , Uh     , Xu     , Uh     , Xu     , Uu^Vu  , Xu     , Cud    , Xu     , Cud    , Xu     , Xu     , Xu     , Xu     , Xu     , Xu     , Xu
Uu     , Uu     , Qxu    , Uu^Vud , Qxu    , Qxu^Bs\, Ur     , Qxu    , Uu     , Qxu    , Qxu    , Uu     , Xu     , Xu     , Uu     , Xu     , Xu     , Qxu    , Qxu    , Qxu    , Qxu    , Qxu    , Qxu    , Xu     , Qxu    , Qxu    , Xu     , Xu     , Xu     , Xu     , Uu^Vu  , Uh     , Uh     , Uh     , Uu     , Cud    , Cud    , 2 Ko   , Cud    , Cud    , Uh     , Uh     , Xu     , Xu     , Xu     , Xu
Uu     , Uu     , Qxu    , Qxu    , Uu     , Uu     , Ur     , Uu     , Uu     , Uu     , Uu     , Uu     , Xu     , Uu     , Uu     , Xu     , Ur     , Uu^Uf  , Ur     , Qxu    , Qxu    , Qxu    , Qxu    , Qxu    , Qxu    , Qxu    , Qxu    , Qxu    , Xu     , Ur     , Xu     , Xu     , Xu     , Uu     , Ur     , Uu     , Ur     , Cud    , Ur     , Ur     , Ur     , Uh     , Uu     , Xu     , Uu     , Xu
Uu     , Uu     , Uu     , Qxu    , Qxu    , Uu     , Uu     , Ur     , Uu     , Uu     , Uu     , Uu     , Xu     , Ur     , Ur^Es  , Ur     , Xu     , Ur     , Uu     , Uu     , Ur     , Xu     , Xu     , Xu     , Uu^Uf  , Uu^Uf  , Qxu    , Xu     , Xu     , Uh     , Uh     , Xu     , Xu     , Uu^Vu  , Ur     , Ur     , Ur     , Ur     , Ur     , Ur     , Ur     , Ur     , Uu     , Uu     , Xu     , Uu
Uu^Uf  , Uu     , Uu^Uf  , Qxu^Bs\, Uu     , Uu     , Uu     , Ur     , Ur     , Uu     , Uu^Vud , Uu^Uf  , Xu     , Xu     , Uu     , Uu     , Uh     , Ur^Es  , Uh     , Xu     , Xu     , Ur     , Uu     , Uu^Uf  , Xu     , Uu^Uf  , Uu^Uf  , Qxu    , Xu     , Uh     , Uu     , Uu     , Uu     , Uu     , Uu^Es  , Ur     , Ur     , Ur     , Ur     , Ur     , Ur     , Ur     , Uu^Vu  , Xu     , Xu     , Xu
Uu     , Uu^Uf  , Qxu    , Qxu    , Uu     , Uu     , Uu     , Uu     , Ur     , Uh     , Uh     , Xu     , Xu     , Xu     , Xu     , Uh     , Uu^Vu  , Uh     , Uh     , Uh     , Uu     , Xu     , Xu     , Ur     , Xu     , Xu     , Xu     , Ur     , Uu     , Xu     , Xu     , Xu     , Uu^Vu  , Uu     , Uu     , Uu     , Xu     , Uu     , Ur     , Ur     , Ur     , Uu     , Xu     , Xu     , Xu     , Xu
Uu     , Qxu    , Qxu    , Uu     , Uu     , Uu^Vud , Uh     , Uu     , Ur     , Uh     , Xu     , Xu     , Xu     , Xu     , Xu     , Xu     , Xu     , Xu     , Xu     , Uh     , Xu     , Uu     , Uu^Uf  , Ur^Es  , Ur     , Uu     , Uu^Es  , Ur     , Uu^Vu  , Xu     , Xu     , Xu     , Xu     , Xu     , Xu     , Xu     , Xu     , Xu     , Uh     , Uu     , Uu     , Ur     , Uu     , Xu     , Xu     , Xu
Uu     , Qxu    , Uu     , Uu     , Uh     , Uh     , Uh     , Ur     , Uu     , Uu     , Uh     , Xu     , Xu     , Xu     , Xu     , Xu     , Uu^Uf  , Xu     , Uu^Uf  , Xu     , Xu     , Xu     , Uu^Uf  , Uu^Uf  , Xu     , Ur     , Xu     , Ur     , Ur     , Uu     , Uu     , Xu     , Uu     , Xu     , Ql     , Xu     , Ql     , Xu     , Uu^Vu  , Uu     , Xu     , Ur     , Ur     , Uu^Es  , Xu     , Xu
Uu^Vud , Qxu    , Uu     , Uu     , Uu     , Uh     , Uu     , Ur     , Ur     , Uu     , Uu^Vud , Xu     , Xu     , Xu     , Xu     , Uu^Uf  , Ur     , Uu^Uf  , Ur^Es  , Ur     , Xu     , Xu     , Xu     , Uu^Uf  , Uu     , Ur     , Ur     , Xu     , Ur     , Uh     , Ur     , Uu     , Uu^Ii  , Ql     , Uu     , Ql     , Ql     , Uh     , Xu     , Uu     , Uu     , Uu     , Ur     , Uu     , Xu     , Xu
Uu     , Qxu    , Qxu^Bs/, Uu     , Uu     , Uu     , Uu     , Uu     , Cud    , Uu     , Uh     , Uh     , Xu     , Xu     , Xu     , Xu     , Ur     , Ur     , Ur     , Ur     , Ql     , Ql     , Ql     , Xu     , Ql     , Uu     , Xu     , Ur     , Ur     , Xu     , Ql     , Ur     , Ql     , Uu^Ii  , Xu     , Xu     , Xu     , Ql     , Uh     , Xu     , Uh     , Uh     , Uh     , Ur     , Xu     , Xu
Uu     , Uu     , Qxu    , Uu     , Uu^Vud , Uu     , Uu     , Cud    , 1 Kud  , Cud    , Uh     , Uh     , Xu     , Xu     , Xu     , Uu^Uf  , Uu^Uf  , Uu^Uf  , Xu     , Ql     , Ql     , Ql     , Ql     , Xu     , Ql     , Xu     , Xu     , Uu     , Ur     , Ql     , Xu     , Ql^Bs| , Ql     , Ql     , Ql     , Ql     , Xu     , Ql     , Ql     , Uh     , Xu     , Uh     , Ur     , Ur     , Xu     , Xu
Qxu    , Qxu    , Uh     , Uu     , Uu^Uf  , Uu^Uf  , Uu     , Cud    , Cud    , Cud    , Uu     , Uh     , Xu     , Xu     , Xu     , Xu     , Xu     , Xu     , Ql     , Ql     , Ql     , Ql     , Ql     , Ql     , Ql     , Ql     , Ql     , Uu     , Ur     , Ur     , Uu     , Uh^Ii  , Uh^Ii  , Ql     , Ql     , Ql     , Ql     , Ql     , Ql     , Xu     , Ur     , Ur^Es  , Uu     , Uu     , Xu     , Xu
Qxu    , Xu     , Xu     , Uu     , Uu     , Uu^Uf  , Uu^Uf  , Uu     , Uh     , Uu     , Uu     , Uu^Vud , Xu     , Xu     , Uh     , Uh     , Xu     , Xu     , Ql     , Ql     , Xu     , Xu     , Ql     , Ql     , Uu^Ii  , Ql     , Uu^Ii  , Uu^Ii  , Xu     , Ur     , Ur^Es  , Uu^Vu  , Uh     , Uh^Ii  , Xu     , Ql     , Ql     , Xu     , Uu^Vu  , Ql^Bs/ , Ql^Bs/ , Ur     , Ur     , Uu^Vu  , Ur     , Xu
Uu     , Qxu    , Xu     , Xu     , Uu     , Uu     , Uh     , Uh     , Uh     , Uh     , Xu     , Xu     , Xu     , Xu     , Uu^Ii  , Uu^Vu  , Ur     , Ql     , Uu^Ii  , Ql     , Xu     , Ql     , Ql     , Ql     , Uu^Vu  , Uu^Ii  , Uh     , Uu     , Ur     , Ur     , Ur^Ii  , Uu     , Ur^Ii  , Ur     , Ur^Es  , Ql     , Ur^Ii  , Ql^Bs/ , Ql^Bs/ , Uu^Ii  , Ql^Bs\ , Xu     , Ur     , Ur     , Xu     , Xu
Qxu    , Qxu    , Qxu    , Xu     , Xu     , Uu     , Xu     , Uh     , Xu     , Uh     , Xu     , Xu     , Xu     , Xu     , Ur     , Ur     , Xu     , Ql^Bs\ , Uu^Ii  , Ql     , Ql     , Ql     , Xu     , Xu     , Uh     , Uu     , Ur     , Ur^Ii  , Ql     , Ur^Ii  , Uu     , Ur     , Ur     , Ur     , Uu     , Ql^Bs/ , Ql     , Uu     , Ql     , Ql     , Uu^Ii  , Uu     , Ur^Es  , Uu     , Xu     , Xu
Xu     , Xu     , Xu     , Qxu    , Qxu    , Xu     , Xu     , Xu     , Xu     , Xu     , Xu     , Xu     , Xu     , Xu     , Ur^Ii  , Uu     , Ql     , Ql     , Ql     , Ql^Bs\ , Ur^Ii  , Ur^Ii  , Ur^Es  , Uh     , Ur     , Ur^Es  , Uu     , Ql     , Ql     , Ql     , Ur     , Xu     , Ur^Ii  , Uh     , Uu^Es  , Uh     , Ql^Bs/ , Uu^Ii  , Ur     , Ql^Bs/ , Xu     , Uu     , Uu     , Ur     , Ur     , Xu
Xu     , Xu     , Xu     , Qxu    , Qxu    , Xu     , Xu     , Xu     , Xu     , Xu     , Xu     , Xu     , Uh     , Uu^Vu  , Ur^Ii  , Ur     , Ql^Bs\ , Ql     , Ql     , Ql     , Ur^Ii  , Ql     , Ql     , Ur     , Xu     , Uh     , Uu^Ii  , Uu     , Ur     , Uu^Ii  , Uh     , Ur^Es  , Uh     , Uu     , Uu     , Uu^Ii  , Ql^Bs\ , Ql     , Ql^Bs| , Ql     , Ql     , Xu     , Uu     , Ur     , Uu     , Xu
Xu     , Xu     , Xu     , Xu     , Xu     , Qxu    , Qxu    , Xu     , Xu     , Xu     , Xu     , Uh     , Xu     , Uh     , Uh     , Ql     , Uh     , Ur     , Ur^Es  , Ql^Bs/ , Ql     , Uu^Ii  , Uu^Ii  , Ql     , Ql^Bs/ , Uu^Ii  , Ur     , Uu^Vu  , Ur     , Uu     , Uu     , Uu     , Uu^Ii  , Ql     , Ql     , Ql     , Ql     , Uu^Ii  , Uu^Ii  , Ql     , Xu     , Xu     , Ur     , Uu     , Uu^Es  , Xu
Xu     , Xu     , Xu     , Xu     , Qxu    , Qxu    , Xu     , Xu     , Xu     , Xu     , Xu     , Xu     , Xu     , Xu     , Ql     , Ql     , Ql     , Uu^Vu  , Ur     , Ql     , Ql^Bs/ , Ql^Bs/ , Ql     , Uu^Ii  , Ql     , Ur     , Xu     , Ur     , Uh^Ii  , Ur     , Xu     , Uu^Ii  , Ql^Bs\ , Ql     , Ql     , Ql     , Uu^Ii  , Ur     , Ql^Bs\ , Ql     , Uu^Ii  , Uu     , Ur^Es  , Ur     , Xu     , Xu
Xu     , Xu     , Xu     , Wwy    , Xu     , Qxu    , Qxu    , Qxu    , Qxu    , Xu     , Ql     , Xu     , Xu     , Xu     , Ql     , Ql     , Ql     , Ql     , Ur     , Uu^Ii  , Ql     , Ql     , Ql     , Ql     , Ql     , Ur     , Ql^Bs\ , Ql^Bs| , Ql^Bs/ , Ur     , Ql     , Ql     , Ql     , Uu     , Ql^Bs/ , Uu^Ii  , Ql     , Ql^Bs\ , Uu^Es  , Uu^Ii  , Uu^Vu  , Xu     , Ur     , Ur     , Xu     , Xu
Xu     , Xu     , Xu     , Wwy    , Wwy    , Xu     , Xu     , Xu     , Xu     , Ql     , Ql     , Ql     , Ql     , Ql     , Ql     , Ql     , Ur     , Ql^Bs/ , Ql     , Ql     , Ql     , Ql     , Xu     , Ql     , Ql     , Ql     , Ql^Bs/ , Ur^Ii  , Ql     , Ql     , Ql     , Ql     , Xu     , Uu     , Ql     , Ql     , Xu     , Uu     , Ur     , Ur     , Ur     , Uu     , Uu     , Xu     , Xu     , Xu
Xu     , Xu     , Xu     , Xu     , Wwy    , Xu     , Xu     , Xu     , Xu     , Xu     , Xu     , Ql     , Ql     , Ql     , Xu     , Ql     , Ql     , Ur     , Ur     , Ql     , Ql     , Ql     , Xu     , Xu     , Ql     , Ur^Ii  , Ql     , Ql^Bs| , Ql     , Ql     , Ql     , Ql     , Ql     , Ql     , Ql     , Ql     , Ql     , Xu     , Xu     , Xu     , Ur     , Ur     , Uu     , Xu     , Xu     , Xu
Xu     , Xu     , Xu     , Xu     , Xu     , Wwy    , Wwy    , Wwy    , Wwy    , Wwy    , Wwy    , Ql     , Xu     , Ql     , Ql     , Ql     , Ql     , Ql     , Ql     , Ql^Bs\ , Ur^Ii  , Ql     , Ql     , Ql     , Ql     , Ql^Bs| , Uu^Ii  , Ur     , Xu     , Ql     , Ql     , Ql     , Ql     , Ql     , Ql     , Ql     , Xu     , Xu     , Ur     , Uu^Vu  , Ur^Es  , Ur     , Uu     , Uu^Es  , Xu     , Xu
Xu     , Xu     , Xu     , Xu     , Xu     , Xu     , Wwy    , Wwy    , Wwy    , Wwy    , Xu     , Xu     , Xu     , Ql     , Ql     , Ql     , Ql     , Ql     , Uu^Ii  , Ql     , Xu     , Ur     , Uu^Ii  , Uu^Ii  , Ur     , Ur     , Ur     , Ur     , Uu^Ii  , Xu     , Ql     , Ql     , Ql     , Xu     , Xu     , Ql     , Xu     , Ur     , Xu     , Ur     , Ur     , Xu     , Ur     , Ur     , Xu     , Xu
Wwy    , Xu     , Wwy    , Wwy    , Wwy    , Wwy    , Wwy    , Wwy    , Wwfy   , Xu     , Xu     , Xu     , Xu     , Xu     , Xu     , Xu     , Uu     , Uu^Ii  , Uu^Ii  , Uu^Ii  , Ur     , Ur     , Ur     , Xu     , Ur^Ii  , Ur^Ii  , Xu     , Uu^Ii  , Xu     , Xu     , Ql     , Ql     , Ql     , Ql     , Ql     , Ql     , Ql     , Uu     , Uh     , Uh     , Ur     , Ur     , Cud    , Ur     , Xu     , Xu
Wwy    , Wwy    , Wwy    , Wwy    , Wwfy   , Wwy    , Uh^Ii  , Uu^Vu  , Uh^Ii  , Uh     , Uh     , Xu     , Uu     , Xu     , Uu     , Uu     , Xu     , Uu     , Ur     , Ur     , Uu^Ii  , Xu     , Ur^Ii  , Ur     , Ur^Es  , Ur^Ii  , Uu     , Uu^Ii  , Xu     , Xu     , Xu     , Uu^Ii  , Uu^Ii  , Ql     , Ql     , Uu     , Ql     , Xu     , Ur     , Ur^Es  , Ur     , Cud    , 3 Ko   , Cud    , Xu     , Xu
Xu     , Wwy    , Xu     , Xu     , Uh^Ii  , Uh^Ii  , Uu^Ufi , Uh^Ii  , Xu     , Uh^Ii  , Uu^Ii  , Ch^Ii  , Uh^Ii  , Uh^Ii  , Uu^Ii  , Xu     , Ur^Ii  , Ur     , Ur^Ii  , Ur     , Ur^Ii  , Ur^Ii  , Xu     , Uu^Ii  , Uu     , Uu     , Uh     , Xu     , Xu     , Xu     , Uu^Vu  , Uu^Ii  , Uu^Ii  , Ql     , Ql     , Ql     , Uu     , Ql^Bs/ , Uu     , Uu^Vu  , Xu     , Cud    , Xu     , Xu     , Xu     , Xu
Xu     , Xu     , Xu     , Xu     , Uu^Ii  , Uh     , Uu^Ii  , Uh^Ii  , Uu^Ufi , Uu^Ii  , Uu^Ufi , Ch^Ii  , Uu^Vu  , Uh^Ii  , Ur^Ii  , Ur     , Ur     , Ur     , Uu     , Uu     , Xu     , Uu     , Xu     , Uu     , Xu     , Uh     , Xu     , Xu     , Xu     , Uu     , Uu     , Uu     , Uu     , Uu^Ii  , Uu     , Ql^Bs/ , Ql     , Ql     , Ql     , Xu     , Xu     , Xu     , Xu     , Xu     , Xu     , Xu
Xu     , Xu     , Xu     , Uh     , Uu^Ii  , Uh^Ii  , Uu^Vu  , Uu^Ii  , Uu^Ii  , Uu^Ii  , Ch^Ii  , 4 Kh^Ii, Ch^Ii  , Ur^Ii  , Uh^Ii  , Uu^Ii  , Xu     , Xu     , Xu     , Xu     , Xu     , Xu     , Xu     , Xu     , Xu     , Xu     , Xu     , Xu     , Xu     , Xu     , Xu     , Uu     , Xu     , Uu     , Xu     , Ql     , Ql     , Ql     , Ql     , Ql     , Ql     , Xu     , Xu     , Xu     , Xu     , Xu
Xu     , Xu     , Xu     , Xu     , Uu^Ufi , Uh^Ii  , Uu     , Uh^Ii  , Uh^Ii  , Ch^Ii  , Uu^Ii  , Uu^Ii  , Uu^Ii  , Ch^Ii  , Uh     , Uu^Ufi , Xu     , Xu     , Xu     , Xu     , Xu     , Xu     , Xu     , Xu     , Xu     , Xu     , Xu     , Xu     , Xu     , Xu     , Xu     , Xu     , Xu     , Xu     , Xu     , Ql     , Ql     , Xu     , Xu     , Ql     , Ql     , Xu     , Xu     , Xu     , Xu     , Xu
Xu     , Xu     , Xu     , Xu     , Xu     , Uh^Ii  , Uh^Ii  , Uh^Ii  , Uh^Ii  , Uu^Ii  , Uu^Ufi , Xu     , Uh     , Uh^Ii  , Uu^Ufi , Uu^Ufi , Xu     , Xu     , Xu     , Xu     , Xu     , Xu     , Xu     , Xu     , Xu     , Xu     , Xu     , Xu     , Xu     , Xu     , Xu     , Xu     , Xu     , Xu     , Xu     , Ql     , Ql     , Ql     , Ql     , Ql     , Ql     , Ql     , Xu     , Xu     , Xu     , Xu
Xu     , Xu     , Xu     , Xu     , Xu     , Uu^Ufi , Uu^Ufi , Uh^Ii  , Uu     , Uu^Ii  , Uh^Ii  , Uu^Ufi , Uh^Ii  , Uh^Ii  , Xu     , Xu     , Xu     , Xu     , Xu     , Xu     , Xu     , Xu     , Xu     , Xu     , Xu     , Xu     , Xu     , Xu     , Xu     , Xu     , Xu     , Xu     , Xu     , Xu     , Xu     , Xu     , Ql     , Ql     , Ql     , Ql     , Ql     , Ql     , Ql     , Xu     , Xu     , Xu
Xu     , Xu     , Xu     , Xu     , Xu     , Xu     , Xu     , Xu     , Xu     , Uh     , Xu     , Uu^Vu  , Xu     , Xu     , Xu     , Xu     , Xu     , Xu     , Xu     , Xu     , Xu     , Xu     , Xu     , Xu     , Xu     , Xu     , Xu     , Xu     , Xu     , Xu     , Xu     , Xu     , Xu     , Xu     , Xu     , Xu     , Xu     , Ql     , Xu     , Ql     , Ql     , Ql     , Ql     , Xu     , Xu     , Xu
Xu     , Xu     , Xu     , Xu     , Xu     , Xu     , Xu     , Xu     , Xu     , Xu     , Xu     , Xu     , Xu     , Xu     , Xu     , Xu     , Xu     , Xu     , Xu     , Xu     , Xu     , Xu     , Xu     , Xu     , Xu     , Xu     , Xu     , Xu     , Xu     , Xu     , Xu     , Xu     , Xu     , Xu     , Xu     , Xu     , Xu     , Xu     , Xu     , Xu     , Ql     , Ql     , Ql     , Ql     , Xu     , Xu
