border_size=1
usage=map

Gg     , Gs     , Gs     , Gs     , Gs     , Gs     , Gg     , Gg     , Re     , Re     , Re     , Re     , Gg     , Gg     , Hh     , Re     , Re     , Re     , Gg     , Gg     , Gg     , Gg     , Ww     , Ww     , Wo     , Wo     , Wo     , Wo     , Ww     , Ww     , Hh     , Mm
Gg     , Gg     , Gg     , Gs     , Gg     , Gs     , Gg^Efm , Gg     , Gg     , Re     , Gg     , Gg     , Hh     , Hh     , Hh     , Re     , Re     , Re     , Gg^Efm , Gg^Vh  , Gg     , Gg     , Ww     , Ww     , Wo     , Wo     , Wo     , Wo     , Ww     , Ww     , Hh     , Hh
Gg     , Gg     , Gg     , Gs^Fms , Gs^Fms , Gg     , Gg     , Gg     , Gg     , Gg     , Gg     , Gg     , Gg     , Hh     , Re^Es  , Re     , Re     , Re     , Gg     , Gg     , Gg     , Gg     , Ww     , Ww     , Wo     , Wo     , Wo     , Wo     , Ww     , Ww     , Ww     , Hh
Gs     , Gg     , Gg     , Gs^Fms , Gg     , Gg     , Gg     , Gg     , Hh^Vhh , Gg     , Ch     , Ch     , Ch     , Re     , Re     , Re     , Re     , Gg     , Gs^Fms , Gs^Fms , Gs^Fp  , Gg     , Gg     , Ww     , Wo     , Wo     , Wo     , Wo     , Wo     , Ww     , Ww     , Gs
Gs     , Gs     , Gg^Vh  , Gg     , Gg     , Gg     , Hh     , Hh     , Hh     , Hh     , Ch     , 2 Kh   , Ch     , Re     , Re     , Re     , Gg     , Gg     , Hh^Fds , Gs^Fds , Gs^Fp  , Gs^Fp  , Gg     , Ww     , Wo     , Wo     , Wo     , Wo     , Wo     , Ww     , Ww     , Gs
Gs     , Gs     , Gs     , Gg     , Gg     , Gg     , Hh     , Hh^Fp  , Gs^Fms , Gg     , Gg     , Ch     , Re     , Re     , Re     , Re     , Gg     , Gs^Fms , Hh     , Hh^Fds , Gg     , Gg     , Ss     , Ww     , Ww     , Wo     , Wo     , Wo     , Wo     , Ww     , Gs     , Hh
Gs     , Gs     , Gs     , Gg^Efm , Gg     , Gs^Fms , Gg^Efm , Gs^Fms , Gg     , Gg     , Gg     , Gg     , Re     , Re     , Re     , Hh     , Gg     , Gg     , Hh     , Hh     , Hh     , Ss     , Ss     , Ss     , Ww     , Wo     , Wo     , Wo     , Wo     , Ww     , Gs     , Gs
Gs     , Gs     , Gs     , Gs     , Gg     , Gg     , Gg     , Gg     , Gg     , Gg     , Gg     , Gg     , Re     , Re     , Re     , Gs     , Gs     , Hh^Vhh , Hh     , Mm     , Hh     , Ss     , Ss     , Ww     , Ww     , Wo     , Wo     , Wo     , Ww     , Ww     , Hh     , Hh
Gs     , Gs     , Gs     , Gs     , Gs^Fms , Gg     , Gg     , Gg     , Gg^Es  , Gg     , Gg     , Gg     , Re     , Re     , Re     , Re     , Gs     , Gg     , Hh     , Hh     , Hh     , Gg     , Wwf    , Ww     , Wo     , Wo     , Wo     , Wo     , Ww     , Hh     , Hh^Vc  , Hh
Gs     , Gg     , Gg     , Gg     , Gg     , Gg     , Gg     , Gg     , Hh     , Hh     , Hh     , Gg     , Re     , Re     , Re     , Gs     , Gs     , Gs     , Gg     , Hh     , Gg     , Gg     , Ww     , Ww     , Wo     , Wo     , Wo     , Wo     , Ww     , Gs     , Hh     , Hh
Gg     , Gg     , Gg^Efm , Gg     , Gg     , Gg     , Hh     , Hh     , Hh^Vc  , Hh     , Gg     , Gg     , Re     , Re     , Re     , Hh     , Gg^Efm , Gg     , Gg^Es  , Gg     , Gg     , Gg     , Ww     , Ww     , Wo     , Wo     , Wo     , Ww     , Ww     , Gs     , Gs     , Hh
Gg     , Gg     , Gs     , Gg     , Gs     , Gg     , Hh     , Hh     , Gg     , Gg     , Re     , Re     , Re     , Re     , Hh     , Hh     , Hh     , Hh     , Hh     , Gg     , Gg     , Wwf    , Ww     , Ww     , Ww     , Ww     , Ww     , Ww     , Gs     , Gs     , Hh     , Hh
Gs     , Gg     , Gs     , Gs     , Gs     , Gg     , Gg     , Hh     , Gg     , Re     , Re     , Re     , Re     , Re     , Hh     , Hh     , Hh     , Hh     , Gg     , Gg     , Wwf    , Wwf    , Ww     , Ww     , Wo     , Ww     , Ww     , Ww     , Gs     , Gs^Es  , Hh     , Hh
Gs     , Gs     , Gs     , Gs^Es  , Gs     , Gs     , Gg     , Gg     , Re     , Re     , Re     , Re     , Gg     , Gg     , Gg     , Hh     , Hh     , Gg^Efm , Gg     , Wwf    , Wwf    , Ww     , Wo     , Wo     , Wo     , Wo     , Ww     , Wwf    , Gg     , Hh     , Hh     , Hh
Gs     , Gs     , Gg     , Gs     , Gg     , Gg     , Re     , Re     , Re     , Re     , Re     , Re     , Gg     , Gg^Es  , Gg     , Gg     , Gg     , Gg     , Gg     , Ww     , Ww     , Ww     , Wo     , Wo     , Wo     , Wo     , Wo     , Gs     , Hh     , Hh     , Hh     , Hh
Gg     , Gg     , Gg^Vh  , Gg     , Re     , Re     , Re     , Re     , Re     , Re     , Gg     , Gg     , Gg     , Gg     , Gg^Vh  , Gg     , Gg     , Gg     , Ww     , Ww     , Ww     , Wo     , Wo     , Wo     , Wo     , Wo     , Gs     , Gs     , Gs     , Hh     , Hh     , Hh
Gg     , Gg     , Gg     , Gg     , Re     , Re     , Re     , Re     , Gs^Fms , Gs^Fms , Gs^Fms , Gg     , Gs^Fms , Gg     , Gg     , Gg     , Gg     , Wwf    , Ww     , Ww     , Wo     , Wo     , Wo     , Wo     , Wo     , Wo     , Gs^Vht , Gs     , Hh     , Hh     , Hh     , Hh^Fp
Gg     , Gg     , Gg     , Gg     , Re     , Re     , Re     , Gs^Fms , Gg     , Gs^Fds , Gs^Fms , Gg     , Gs^Fms , Gs^Fds , Ss     , Gg     , Wwf    , Ww     , Ww     , Ww     , Wo     , Wo     , Wo     , Wo     , Gg     , Gg     , Gs     , Gs     , Gs     , Gs     , Hh     , Hh
Gg     , Gg     , Gg^Efm , Re     , Re^Es  , Re     , Re     , Gs^Fp  , Gs^Fms , Gg     , Gs^Fds , Gs^Fms , Gg     , Gs^Fms , Ww     , Ww     , Ww     , Ww     , Ww     , Ww     , Ww     , Wo     , Ww     , Ww     , Gg     , Gs     , Gs     , Gs     , Gs     , Hh     , Hh     , Mm
Gg     , Gg     , Gg     , Re     , Re     , Re     , Hh     , Gg     , Gg     , Gs^Fms , Gs^Fms , Gs^Fms , Ss     , Gs^Fms , Ww     , Ww     , Wo     , Ww     , Gg     , Gg^Es  , Wwf    , Ww     , Wwf    , Gg     , Gg     , Gs     , Gs     , Gs     , Hh     , Gg     , Hh     , Mm
Hh     , Hh     , Hh     , Re     , Re     , Re     , Hh     , Hh     , Gg     , Gs^Fms , Gg     , Ss     , Ww     , Ww     , Ww     , Wo     , Wo     , Ww     , Ww     , Ww     , Ww     , Wwf    , Gg     , Gg     , Gg     , Gg     , Gg     , Hh     , Hh     , Hh     , Hh     , Hh
Gg     , Gg     , Hh     , Hh     , Re     , Re     , Re     , Gg^Efm , Ss     , Ss     , Ss     , Ww     , Wo     , Ww     , Wo     , Wo     , Wo     , Wo     , Ww     , Ww     , Gg     , Gg     , Gg^Vl  , Gg     , Gg     , Gg     , Ce     , Hh     , Hh     , Gg     , Hh     , Hh
Gs^Fms , Gg     , Gg     , Gg     , Re     , Re     , Re^Es  , Gg     , Gs^Fms , Ss     , Gg     , Wo     , Wo     , Wo     , Wo     , Wo     , Wo     , Wo     , Ww     , Ww     , Gg     , Gg     , Gg     , Gg     , Hh     , Ce     , 1 Ke   , Ce     , Hh     , Hh     , Hh     , Hh
Gs^Fms , Gs^Fms , Gg     , Gg^Efm , Re     , Re     , Re     , Gs^Fms , Ss     , Ss     , Wo     , Wo     , Wo     , Wo     , Wo     , Wo     , Wo     , Ww     , Wwf    , Wwf    , Gg     , Gg     , Gg     , Hh     , Hh     , Ce     , Ce     , Ce     , Gs     , Hh     , Hh     , Hh^Fp
Gs^Fds , Gs^Fds , Gs^Fms , Re     , Re     , Re     , Re     , Gg     , Gg     , Wo     , Wo     , Wo     , Wo     , Wo     , Wo     , Wo     , Ww     , Ww     , Wwf    , Gg     , Gg     , Gg^Efm , Gg     , Gg     , Gs     , Gs     , Gs^Fp  , Hh     , Hh     , Hh     , Hh     , Hh
Gs^Fds , Gs^Fds , Gs^Fds , Re     , Re     , Re     , Gg     , Ss^Vhs , Gg     , Ww     , Wo     , Wo     , Wo     , Wo     , Wo     , Wo     , Ww     , Wwf    , Wwf    , Gg     , Gg     , Gg     , Gg     , Gs     , Gs     , Gs     , Hh^Fms , Hh^Fp  , Hh     , Hh     , Hh     , Mm
Gs^Fds , Gs^Fds , Gs^Fms , Re     , Re     , Re     , Gg     , Gg     , Gg     , Ww     , Ww     , Wo     , Wo     , Wo     , Wo     , Wo     , Ww     , Wwf    , Gg     , Gg     , Gs^Fms , Gs^Fms , Gs^Fds , Gs^Fms , Gs     , Gs^Fp  , Hh^Fms , Hh^Fds , Hh     , Hh     , Hh     , Hh
Gs^Fms , Gs^Fms , Khr    , Re     , Re     , Re     , Khr    , Gg^Efm , Gg     , Ww     , Ww     , Wo     , Wo     , Wo     , Wo     , Ww     , Ww     , Wwf    , Rb     , Gg     , Gs^Fms , Gs^Fds , Gs^Fds , Gs^Fms , Gs^Fms , Gs     , Hh     , Gg^Es  , Hh     , Hh^Vhh , Hh     , Hh^Fp
Gg     , Chr    , Chr    , Re     , Re     , Re     , Chr    , Chr    , Hh     , Ww     , Ww     , Wo     , Wo     , Wo     , Wo     , Ww     , Ww     , Rb     , Rb     , Gg     , Gg     , Gg     , Gs     , Gs^Fms , Gs     , Gs     , Gs     , Hh     , Hh     , Hh     , Hh     , Hh
Gg     , Gg     , Gg     , Re     , Re     , Re     , Gs^Fms , Hh     , Hh     , Hh     , Ww     , Ww     , Wo     , Wo     , Wo     , Ww     , Ww     , Wwf    , Rb     , Rb     , Rb     , Gg^Vh  , Gs     , Gs     , Hh     , Gs     , Gs     , Gs^Es  , Gs     , Gs     , Gs^Es  , Hh
Hh     , Gg     , Gg     , Re^Es  , Re     , Re     , Gs     , Gg     , Hh     , Hh     , Hh     , Ww     , Ww     , Wo     , Wo     , Wo     , Ww     , Wwf    , Wwf    , Rb     , Rb     , Gs     , Gs     , Gs^Es  , Hh     , Hh     , Gs     , Gs     , Hh     , Gs     , Hh     , Hh
Hh     , Hh     , Gg     , Re     , Re     , Re     , Re     , Gs     , Hh     , Hh^Vhh , Hh     , Ww     , Ww     , Wo     , Wo     , Wo     , Ww     , Wwf    , Ww     , Ww     , Ww     , Rb     , Gg     , Gs     , Gg     , Hh     , Gg     , Gs     , Gs     , Hh     , Hh     , Hh
Hh     , Hh     , Hh     , Re     , Re     , Gs^Fms , Re     , Gs     , Gg     , Hh     , Gs     , Ww     , Ww     , Ww     , Ww     , Ww     , Ww     , Ww     , Wo     , Ww     , Ww     , Ww     , Gg     , Gg^Efm , Gg^Efm , Gg     , Gs     , Hh     , Gs     , Gs     , Hh     , Hh
Gg     , Gg     , Gg^Efm , Re     , Re     , Re     , Re     , Re     , Gs     , Gg^Es  , Gs     , Gs     , Rb     , Wwf    , Ww     , Ww     , Wo     , Wo     , Wo     , Wo     , Wo     , Ww     , Ww     , Gg^Efm , Gg^Efm , Gs     , Gs     , Hh     , Gs     , Gs     , Gs     , Hh
Gg     , Gg     , Gg^Vh  , Gg     , Gg^Efm , Re     , Re     , Re     , Re     , Gs     , Gs     , Re     , Gs     , Wwf    , Ww     , Ww     , Ww     , Wo     , Wo     , Wo     , Wo     , Wo     , Wo     , Ww     , Gg^Efm , Gg^Efm , Gs     , Gs     , Hh     , Gs     , Gs     , Gs
Gs^Fms , Gg     , Gg     , Gg     , Gg^Efm , Re     , Re     , Re     , Re     , Re     , Re     , Gs     , Re     , Gg^Efm , Gg^Vh  , Ww     , Ww     , Ww     , Ww     , Wo     , Wo     , Wo     , Wo     , Ww     , Ww     , Ss     , Ss^Vhs , Ss     , Ss     , Gs     , Gs     , Hh
Gg     , Gg     , Gg     , Gs^Fms , Gs^Fms , Gg^Efm , Gg     , Re     , Re     , Re     , Re     , Re     , Re     , Re     , Re^Es  , Hh     , Hh     , Ww     , Ww     , Wo     , Wo     , Wo     , Wo     , Wo     , Ww     , Ww     , Ss     , Ss     , Ss     , Ss     , Gs     , Gs
Gg     , Gg     , Gg     , Gs^Fds , Gg     , Gg     , Gg     , Gg     , Gg     , Re     , Re     , Re     , Re     , Re     , Re     , Re     , Hh     , Hh     , Ww     , Ww     , Ww     , Wo     , Wo     , Wo     , Wo     , Ww     , Ww     , Ss     , Ss     , Gs     , Gs     , Gs
Gs^Fms , Gg     , Gg     , Gg     , Gs^Fms , Gg     , Gs^Fms , Hh     , Hh     , Hh     , Hh     , Re     , Gs^Fms , Re     , Re     , Re     , Re     , Hh     , Hh     , Ww     , Ww     , Ww     , Wo     , Wo     , Wo     , Wo     , Ww     , Gg     , Hh     , Gs^Es  , Hh     , Gs
Gg     , Gs^Fms , Gs^Fms , Gs^Fms , Gs^Fds , Gs^Fms , Gs^Fms , Hh^Fms , Hh^Fms , Gs^Fms , Gs^Fms , Gg^Fms , Gg     , Re     , Re     , Re     , Re     , Re     , Hh     , Hh     , Hh     , Ww     , Ww     , Wo     , Wo     , Wo     , Wo     , Gg     , Gg     , Hh     , Hh     , Hh
Gg     , Gs^Fms , Gs^Fms , Gg     , Gs^Fms , Gg     , Gs^Fms , Hh^Fms , Gs^Fms , Gs^Fms , Gg     , Gg     , Gg     , Gg     , Gg     , Re     , Re     , Re     , Re     , Gg^Efm , Gg     , Ww     , Ww     , Wo     , Wo     , Wo     , Wo     , Ww     , Gg     , Hh     , Gs     , Hh
Gs^Fms , Gs^Fds , Gs^Fp  , Gs^Fms , Gg     , Gs^Fms , Gs^Fms , Hh^Fms , Hh^Fp  , Gs^Fms , Gs^Fms , Gg     , Gg     , Gs^Fms , Gs^Fms , Gs^Fms , Re     , Re^Es  , Re     , Gg^Efm , Gg^Efm , Gg^Efm , Ww     , Ww     , Wo     , Wo     , Wo     , Wo     , Ww     , Gs^Vht , Gs     , Hh
Gs^Fms , Gs^Fms , Gs^Fds , Gs^Fms , Gs^Fms , Gg     , Gs^Fms , Gs^Fms , Gs^Fms , Gs^Fms , Gs^Fds , Gg     , Gg     , Gg     , Gs^Fms , Gs^Fds , Re     , Re     , Gs^Fds , Gg^Efm , Gg^Efm , Gg^Efm , Gg     , Ww     , Ww     , Wo     , Wo     , Wo     , Wo     , Gg     , Gs     , Gs
Hh^Fms , Gs^Fds , Gs^Fds , Gg     , Gs^Fms , Gs^Fms , Gg     , Gs^Fds , Gs^Fms , Gs^Fds , Gg     , Gg     , Gg^Vh  , Gs^Fms , Gg     , Re     , Re     , Re     , Gs^Fds , Gs^Fds , Gs^Fms , Gg     , Gg     , Ww     , Ww     , Wo     , Wo     , Wo     , Wo     , Ww     , Gg     , Gs
Hh^Fms , Hh^Fms , Hh^Fms , Gs^Fms , Hh^Fms , Gs^Fms , Gs^Fms , Gg     , Gg^Efm , Gg^Efm , Gg^Efm , Gg     , Gg     , Gg     , Gg     , Re     , Re     , Re     , Gs^Fms , Gs^Fds , Gs^Fms , Gg     , Gg     , Gg     , Ww     , Ww     , Wo     , Wo     , Wo     , Ww     , Gg     , Hh
Hh^Fms , Hh^Fms , Hh^Fms , Hh^Fms , Gs^Fms , Gs^Fms , Gs^Fms , Gg     , Gg     , Gg     , Gs^Fms , Gs^Fms , Gs^Fms , Gs^Fms , Gg     , Gs^Fms , Re     , Re     , Re     , Gs^Fms , Gg     , Gg     , Gs     , Wwf    , Ww     , Ww     , Ww     , Wo     , Wo     , Wo     , Gg     , Gg
Gg     , Gg     , Gg     , Gg     , Gs^Fms , Gs^Fds , Gs^Fms , Gs^Fds , Gg     , Gg     , Gs^Fms , Gs^Fds , Gs^Fp  , Gs^Fms , Gs^Fms , Re     , Re     , Re     , Re     , Gg     , Gg     , Gs^Vht , Gs     , Wwf    , Ww     , Ww     , Ww     , Wo     , Wo     , Wo     , Wo     , Gg
Gs^Fms , Gg     , Gg     , Gs^Fms , Gg     , Gg^Es  , Gg     , Gg     , Gg     , Gs^Fms , Gs^Fms , Gs^Fms , Gs^Fds , Gs^Fms , Gs^Fds , Re     , Re^Es  , Re     , Hh     , Hh     , Gg^Efm , Gs     , Gs     , Ww     , Ww     , Wo     , Wo     , Ww     , Ww     , Wo     , Wo     , Gs
Gs^Fms , Gs^Fms , Gg     , Gg     , Gg^Vh  , Gg     , Gs^Fms , Gg     , Gg     , Gg     , Gs^Fms , Gg     , Gg     , Gs^Fms , Gg     , Re     , Re     , Re     , Hh     , Gg     , Gg^Efm , Gg     , Ww     , Ww     , Wo     , Wo     , Wo     , Ww     , Ww     , Wo     , Gs     , Gs
Gs^Fms , Gs^Fms , Gg     , Gg     , Gs^Fms , Gg     , Gs^Fms , Gs^Fms , Gg     , Gg     , Gg     , Gg     , Gg^Efm , Gg^Efm , Gg^Efm , Re     , Re     , Re     , Hh     , Hh^Vhh , Hh     , Hh     , Ww     , Ww     , Wo     , Wo     , Wo     , Wo     , Ww     , Gs     , Gs     , Gs
Gs     , Gg     , Gg     , Gs^Fms , Gg     , Gs^Fms , Hh^Fms , Gs^Fp  , Gg     , Gg     , Gg     , Gg^Efm , Gg     , Gg^Efm , Gg     , Re     , Re     , Re     , Gg     , Hh     , Hh     , Hh     , Ww     , Ww     , Wo     , Wo     , Wo     , Ww     , Gg     , Gg     , Gg     , Gg^Efm
Gs     , Gs     , Gg     , Gg     , Gs^Fms , Gs^Fms , Gs^Fms , Gs^Fms , Gs^Fms , Gg     , Re     , Re     , Re     , Re     , Re     , Re     , Re     , Re     , Gg     , Hh     , Hh     , Ww     , Ww     , Wo     , Wo     , Wo     , Wo     , Ww     , Gg     , Gg     , Hh     , Hh
