border_size=1
usage=map

Ww     , Wo     , Wo     , Wo     , Wo     , Wo     , Wo     , Wo     , Wo     , Ww     , Ww     , Gg^Fds , Gg^Fds , Gg^Fds , Gg^Fds , Gg^Fds , Gg^Fds , Gg^Fds , Gg^Fds , Gg^Fds , Gg^Fds , Gg^Fds , Gg^Fds , Gg^Fds , Gg^Fds , Gg^Fds , Gg^Fds , Gg^Fds , Gg^Fds , Gg^Fds , Gg^Fds , Gg^Fds , Gg^Fds , Gg^Fds
Ss     , Ww     , Ww     , Wo     , Wo     , Wo     , Wo     , Wo     , Wo     , Wo     , Wo     , Ww     , Ww     , Gg^Fms , Gg^Fds , Gg^Fet , Gg^Fms , Gg^Fds , Gg^Fms , Gg^Fds , Gg^Fds , Gg^Fms , Cv     , Cv     , Cv     , Gg^Fms , Gg^Fds , Gg^Fms , Gg^Fds , Gg^Fms , Gg^Fms , Gg^Fp  , Gg^Fds , Gg^Fds
Ss     , Ss     , Gg^Fds , Ww     , Ww     , Wo     , Wo     , Wo     , Wo     , Wo     , Wo     , Wo     , Wo     , Ww     , Ww     , Gg^Fds , Gg     , Ds     , Ds     , Gg^Gvs , Gg^Fds , Gg^Fds , Cv     , 2 Kv   , Cv     , Gg^Fds , Gg^Fds , Gg^Gvs , Gg^Fds , Gg^Fds , Gg^Fds , Gg^Ve  , Gg^Fms , Gg^Fds
Gg^Fds , Gg^Fms , Gg^Fds , Gg^Fds , Ww     , Wo     , Wo     , Wo     , Wo     , Wo     , Wo     , Wo     , Wo     , Wo     , Wo     , Ww     , Ww     , Ww     , Ww     , Gg^Fds , Gg^Ve  , Gg^Fds , Gg^Fms , Cv     , Gg^Fds , Gg^Fds , Gg^Fds , Gg^Fds , Gg^Gvs , Gg^Fds , Gg^Fds , Gg^Fet , Gg^Fds , Gg^Fds
Gg^Fds , Gg^Fms , Gg^Fds , Gg^Fds , Ds     , Ww     , Ww     , Wo     , Wo     , Wo     , Wo     , Wo     , Wo     , Wo     , Wo     , Wo     , Wo     , Ww     , Ww     , Gg     , Ww     , Gg^Fds , Gg^Fds , Gg^Fds , Gg^Fds , Gg^Fds , Gg^Fms , Gg^Gvs , Gg^Ve  , Gg^Fds , Gg^Fds , Gg^Fms , Gg^Fms , Gg^Fds
Gg^Fds , Gg^Fds , Ce     , Ce     , Ce     , Ds     , Ds^Vct , Ww     , Ww     , Wo     , Wo     , Wo     , Wo     , Wo     , Wo     , Wo     , Wo     , Wo     , Wo     , Ww     , Ww     , Ww     , Ww     , Gg     , Gg     , Gg^Fds , Gg^Fds , Gg^Fds , Gg^Fds , Gg^Gvs , Gg^Fds , Gg^Fms , Gg^Fds , Gg^Fds
Gg     , Gg     , Ce     , 1 Ke   , Ce     , Gg     , Gg     , Gg     , Gg^Fds , Ww     , Ww     , Wo     , Ww^Vm  , Wo     , Wo     , Wo     , Wo     , Wo     , Wo     , Wo     , Wo     , Ww     , Ww     , Wwf    , Wwf    , Gg^Fds , Ww     , Gg^Fds , Gg     , Gg^Fds , Gg^Fds , Gg^Fds , Gg^Fds , Gg^Fds
Rp     , Gg     , Re     , Ce     , Gg^Fds , Gg^Fds , Gg^Fds , Gg^Fds , Gg^Fds , Gg^Fms , Gg^Fds , Ww     , Ww     , Wo     , Wo     , Wo     , Wo     , Wo     , Wo     , Wo     , Wo     , Wo     , Wo     , Wwf    , Ww     , Ww     , Gg^Ve  , Ww     , Ww     , Gg^Fds , Gg^Fds , Gg^Fds , Ds     , Gg^Fds
Gg     , Rp     , Rp     , Gg     , Gg     , Gg^Fds , Gg^Fds , Gg^Fms , Gg^Fds , Gg^Fds , Gg^Fds , Gg     , Ss     , Ww     , Ww     , Wo     , Wo     , Wo     , Wo     , Wo     , Wo     , Wo     , Wo     , Ww     , Wwf    , Wo     , Wo     , Gg^Fds , Gg^Fds , Ww     , Ww     , Gg     , Ds     , Ds
Gg     , Gg     , Gg     , Rp     , Rr     , Gg     , Gg     , Gg^Fds , Gg     , Gg^Fds , Gg     , Gg     , Ww     , Ww     , Gg^Fds , Ww     , Ww     , Wo     , Wo     , Wo     , Wo     , Wo     , Ww     , Wwf    , Ww     , Wo     , Wo     , Wo     , Wo     , Ww     , Ww     , Ww     , Ww     , Ww
Gg     , Gg     , Gg     , Gg     , Gg     , Rr     , Rp     , Gg     , Rp     , Gg^Vl  , Ww     , Ww     , Gg^Fds , Gg^Fds , Gg^Fds , Gg^Fds , Gg     , Ww     , Ww     , Ds     , Ww     , Wo     , Ww     , Wwf    , Wwf    , Wo     , Wo     , Wo     , Wo     , Wo     , Wo     , Wo     , Wo     , Wo
Gs^Fds , Gg^Fds , Gg^Fds , Gg^Fds , Gg     , Gg     , Gg     , Rp     , Rb     , Rp     , Ww^Bw\ , Gg     , Gg     , Gg^Fds , Gg     , Gg     , Gg     , Ds     , Ds     , Ds     , Ds^Vct , Ww     , Gg     , Wwf^Es , Wwf    , Wo     , Wo     , Wo     , Wo     , Wo     , Wo     , Wo     , Wo     , Wo
Gs^Fds , Gg^Fms , Gg^Fds , Gg^Fds , Gg^Fds , Gg^Fds , Ss     , Rb     , Ww     , Gg     , Ww     , Rp     , Rp     , Gg^Fds , Gg     , Gg^Fds , Gg^Fds , Gg     , Gg     , Gg     , Gg     , Gg     , Re     , Rb     , Ww     , Ww     , Wo     , Wo     , Wo     , Wo     , Wo     , Wo     , Wo     , Wo
Gg^Fds , Gg^Fds , Gg^Fp  , Gg^Fms , Gg     , Ss     , Ww     , Ww     , Ss     , Ww     , Ss     , Gg     , Gg     , Rr     , Rr     , Gg     , Gg     , Gg     , Gg     , Gg^Fds , Gg     , Gg^Es  , Re     , Gg     , Gg     , Ww     , Ww     , Wo     , Ww     , Wo     , Wo     , Wo     , Wo     , Wo
Gs^Fp  , Gg^Fds , Gg^Fds , Gg^Fds , Ss     , Ww     , Ss     , Ss     , Ss     , Gg^Fds , Gg^Fds , Gg^Fds , Gg^Fds , Gg     , Gg     , Rp     , Rr     , Rp     , Rr     , Rp     , Rp     , Re     , Gg     , Gg     , Gg^Fds , Gg     , Gg^Fds , Ww     , Gg^Fds , Ww     , Ww     , Wo     , Ww     , Wo
Hh^Fet , Gg^Fms , Gg^Fds , Gg^Fms , Ss     , Ww     , Ss     , Ss     , Gg^Fds , Gg^Fds , Ss     , Gg     , Gg^Fds , Gg     , Gg     , Gg     , Gg     , Gg^Es  , Gg     , Gg     , Gg     , Rp     , Rp     , Gg^Fds , Gg^Fds , Gg^Fds , Gg^Fds , Gg^Fds , Gg^Fms , Gg     , Ww     , Ww     , Ww     , Wo
Gs^Fp  , Gg     , Gg     , Gg^Fds , Gg     , Ww     , Ww     , Ss^Vhs , Ss     , Gg^Fds , Gg^Fms , Gg     , Hh     , Gg^Fms , Gg     , Gg     , Gg     , Gg     , Gg     , Gg     , Gg     , Gg     , Gg     , Rp     , Rr     , Gg     , Gg     , Gg^Fds , Gg^Fds , Gg     , Ww     , Ds     , Ds     , Ww
Hh     , Gg^Fds , Gg^Fds , Gg^Fds , Gg^Fds , Gg^Fds , Ww     , Ss     , Gg^Fms , Gg^Fds , Gg^Fds , Gg^Fds , Hh^Fds , Gg^Fds , Gg^Fds , Gg^Fds , Gg^Fds , Gg^Fds , Gg^Fds , Gg     , Gg^Fds , Gg     , Gg^Fds , Gg     , Gg     , Rr     , Rr     , Gg     , Gg     , Ww     , Gg     , Ds     , Gg^Fds , Ds
Hh^Fp  , Hh^Fds , Gg^Fds , Ss     , Ww     , Ww     , Gg^Fms , Gg     , Gg^Fds , Gg     , Hh     , Hh^Fds , Hh     , Gg^Fds , Gg^Fds , Gg^Fds , Gg^Fds , Gg^Fds , Gg     , Gg^Fds , Gg^Fds , Gg     , Gg     , Gg     , Gg     , Gg     , Gg     , Rp     , Rp     , Ww     , Gg     , Gg     , Gg     , Gg^Fds
Hh^Fp  , Gg^Fms , Gg^Fms , Gg^Fds , Ww     , Gg^Fms , Gg^Fms , Gg^Fds , Gg^Fds , Hh     , Hh^Fds , Hh     , Gg     , Gg^Fds , Gg^Fds , Re^Vct , Re     , Re^Es  , Gg^Fds , Gg^Fds , Gg^Fds , Gg^Fds , Gg     , Gg^Fds , Hh^Fds , Gg^Es  , Hh     , Gg     , Ww     , Ww^Bw\ , Re     , Re     , Re     , Gg
Ss     , Ss     , Ss     , Ww     , Ss     , Ss     , Gg^Fds , Gg^Fds , Gg^Fms , Gg^Fds , Hh     , Gg^Fds , Gg^Fds , Gg^Fds , Gg^Fds , Re     , Re     , Re     , Re     , Re^Vct , Gg^Fds , Gg^Fds , Gg^Fds , Gg^Fds , Gg     , Hh     , Hh     , Gg     , Ww     , Gg     , Ss     , Gg     , Ss     , Re
Ss     , Ss     , Ss     , Ww     , Gg^Fds , Gg^Fms , Gg^Fds , Gg^Fds , Gg^Fds , Gg^Fds , Gg^Fds , Gg     , Gg^Fds , Gg     , Re     , Re     , Re     , Re     , Gg^Fds , Re     , Re     , Gg^Fms , Gg^Fds , Gg^Fms , Gg^Fds , Hh     , Hh     , Hh     , Ww     , Ss     , Gg^Fds , Ss     , Ss     , Ss
Hh     , Gg^Fms , Gg^Fms , Ww     , Ww     , Gg     , Gg^Fds , Gg^Fds , Hh     , Gg     , Gg     , Gg^Fds , Gg     , Gg^Fds , Gg     , Gg^Fds , Ce     , Ce     , Ce     , Re     , Gg^Fds , Gg^Fds , Gg^Fds , Gg^Fds , Gg     , Gg^Fds , Ww     , Ww     , Ww     , Ww     , Ww     , Ss     , Gg^Fds , Ss
Hh     , Gg^Fds , Gg^Fds , Gg^Fds , Ww     , Gg     , Ss     , Gg^Fms , Hh^Fms , Hh     , Gg^Fds , Gg     , Gg^Fds , Gg^Fds , Gg^Fds , Gg     , Gg^Fds , Ke     , Gg^Fds , Gg^Fds , Gg     , Gg     , Gg^Fds , Gg^Fds , Gg^Fds , Gg     , Ww     , Ww     , Ww     , Ww     , Ww     , Ss     , Ss     , Ss
Hh^Fp  , Hh^Fms , Gg^Fms , Ss     , Ss     , Ww     , Ww     , Ss     , Gg^Fms , Hh     , Hh     , Gg^Fds , Gg^Fds , Gg^Fds , Gg^Fms , Hh^Fds , Gg^Fds , Gg^Fds , Hh^Fds , Gg^Fds , Gg^Fms , Gg^Fds , Hh     , Gg     , Gg^Fds , Gg     , Ss     , Ww     , Ss     , Gg     , Gg^Fms , Gg^Fds , Gg^Fds , Gg^Fds
Hh^Fp  , Hh^Fp  , Hh^Fp  , Hh^Fp  , Gg^Fp  , Hh^Fp  , Hh^Fp  , Ww     , Gg^Fms , Hh     , Hh^Fds , Gg^Fds , Gg^Fds , Gg^Fds , Gg^Fds , Gg^Fds , Gg^Fds , Gg^Fds , Gg^Fds , Gg^Fds , Gg^Fds , Gg^Fds , Gg^Fds , Gg^Fds , Gg^Fds , Ss     , Gg^Fms , Ss     , Gg^Fds , Gg^Fds , Gg^Fds , Gg^Fds , Gg^Fds , Gg^Fds
