border_size=1
usage=map

Gg^Fds, Gg^Fds, Gg^Fds, Gg^Fds, Gg^Fds, Gg^Fds, Gg^Fds, Gg^Fds, Gs^Fds, Gg^Fds, Gg^Fds, Gg^Fds, Gg^Fds, Gg^Fds, Gg^Fms, Gg^Fds, Gg^Fds, Gg^Fds, Gg^Fds, Gg^Fds, Gg^Fds, Gg^Fds, Gg    , Gg    , Gg    , Gg    , Gg    , Gg    , Gg    , Gg    , Gg    , Gg    , Gg    , Gg    , Gg    , Gg    , Gg    , Gg    , Gg    , Gg    , Gg    , Gg    , Gg    , Gg    , Gg    , Gg
Gg^Fds, Gg^Fds, Gg^Fds, Gg^Fds, Gg^Fds, Gg^Fds, Gg^Fds, Gg^Fds, Gg^Fms, Gg^Fds, Gg^Fds, Gg^Fds, Gs^Fds, Gs^Fds, Gg^Fds, Gg^Fds, Gg^Fds, Gg^Fds, Co    , Co    , Co    , Gg    , Gg    , Gg    , Gg    , Gg    , Gg    , Gg    , Gg    , Gg    , Gg    , Gg    , Gg    , Gg    , Gg    , Gg    , Gg    , Gg    , Gg    , Gg    , Gg    , Gg    , Ds    , Gg    , Ww    , Ww
Gg    , Gg    , Gg    , Gg^Fds, Gg^Fds, Gg^Fms, Gg^Fds, Gg^Fds, Gg^Fds, Gg^Fds, Gg^Fds, Gg^Fds, Gg^Fms, Gg^Fds, Gg    , Gg    , Gg^Vh , Gg    , Co    , 2 Ko  , Co    , Gg    , Gg    , Gg    , Gg^Vh , Gg    , Gg    , Gg    , Gg    , Gg    , Hh    , Gg    , Hh    , Gg^Fms, Hh    , Hh    , Hh    , Hh    , Gg^Es , Gg    , Ss    , Gg    , Ss    , Ww    , Ww    , Ww
Gg    , Gg    , Gg    , Gg^Fds, Gg^Fds, Gg^Fds, Gg^Fds, Gg^Fds, Gg    , Gg^Fds, Gs^Fds, Gg^Fds, Gg    , Gg    , Gg    , Gg    , Gg    , Gg    , Gg    , Co    , Gg^Em , Gg    , Gg    , Gg    , Gg    , Gg    , Gg    , Gg^Es , Gg    , Gg    , Gg^Fms, Hh    , Hh^Fds, Hh^Fms, Hh^Fms, Hh    , Gg    , Gg    , Gg    , Gg    , Ss    , Ss    , Ww    , Ww    , Ww    , Ww
Gg    , Gg    , Gg    , Gg    , Gg    , Gg^Fds, Gg    , Gg^Fds, Gg    , Gg    , Gg    , Gg    , Gg    , Gg    , Gg    , Gg    , Gg    , Gg    , Gg    , Gg    , Gg    , Gg    , Gg    , Gg    , Gg    , Gg    , Gg    , Gg    , Gg    , Gg    , Gg^Fms, Gg^Fms, Hh^Fms, Hh^Fms, Gg^Fms, Gg^Fms, Gg    , Gg    , Gg    , Ss    , Ss    , Ss    , Ww    , Ww    , Ww    , Ss
Gg    , Gg    , Gg    , Gg    , Gg    , Gg    , Gg    , Gg    , Gg    , Gg    , Gg    , Gg    , Gg    , Gg    , Gg    , Gg    , Gg    , Gg    , Gs^Fds, Gg    , Gg^Es , Gg    , Gg    , Gg    , Gg    , Gg    , Gg^Fds, Gg    , Gg    , Gg    , Gg    , Hh    , Hh    , Gg    , Gg    , Gg    , Gg    , Gg    , Gg    , Ss    , Ss    , Ww    , Ww    , Ww    , Ww    , Gg
Gg    , Gg    , Gg    , Gg    , Gg    , Gg    , Gg^Es , Gg    , Gg    , Gg    , Gg^Vl , Gg    , Gg    , Gg    , Gg    , Gg    , Gg    , Gg    , Gg    , Gg    , Gg    , Gg    , Gg    , Gg    , Gg    , Gg    , Gg    , Gg    , Gg    , Gg    , Gg    , Hh    , Gg    , Gg    , Gg    , Gg    , Gg    , Gg    , Ss    , Ss    , Ww    , Ww    , Gg    , Ww    , Ww    , Gg
Rp    , Gg    , Gg    , Gg    , Gg    , Gg    , Gg    , Gg    , Gg    , Gg    , Gg    , Gg    , Gg^Fms, Gg    , Gg^Fms, Gg    , Gg^Fms, Gg    , Gg    , Gg    , Gg    , Gg    , Gg    , Gg    , Gg    , Gg    , Gg    , Gg    , Gg    , Gg    , Gg    , Gg    , Gg    , Gg    , Gg    , Gg    , Gg    , Ss    , Ss    , Ss    , Ww    , Ww    , Ww    , Ww    , Gg    , Gg
Rp    , Rp    , Rp    , Gg    , Gg    , Gg    , Gg    , Gg    , Gg    , Gg    , Gg    , Gg    , Gg    , Gg^Fms, Gg^Fds, Gg^Fms, Gg^Fms, Gg    , Gg    , Gg    , Gg^Fds, Gg^Fds, Gg^Fds, Gg    , Gg    , Gg    , Gg    , Gg^Fds, Gg    , Gg    , Gg    , Gg    , Gg    , Gg    , Gg    , Gg    , Gg^Vh , Gg    , Gg    , Ss    , Ww    , Ss    , Ww    , Ww    , Gg    , Gg
Gg    , Rp    , Rp    , Rp    , Rp    , Gg    , Gg    , Gg    , Gg    , Gg    , Gg    , Gg    , Gg    , Gg^Fms, Gg^Fms, Gg^Fms, Gg    , Gg    , Gg    , Gg    , Hh^Fds, Hh^Fds, Hh    , Gg    , Gg    , Gg    , Gg    , Gg    , Gg    , Gg^Es , Gg    , Gg    , Gg    , Gg    , Hh    , Hh    , Gg    , Gg    , Gg    , Ww    , Ww    , Ww    , Ww    , Gg    , Gg    , Gg
Gg    , Gg    , Gg    , Rp    , Rp    , Rp    , Rp    , Gg    , Rp    , Rp    , Rp    , Gg    , Gg    , Gg    , Gg    , Gg^Fms, Gg    , Gg    , Gg    , Gg    , Gg    , Hh    , Gg    , Gg    , Gg    , Gg    , Hh    , Gg    , Gg    , Gg    , Gg    , Gg    , Gg    , Hh    , Hh^Fms, Hh    , Gg^Fms, Gg    , Ww    , Ww    , Ww    , Ww    , Ww    , Gg    , Gg^Fms, Gg^Fms
Gg    , Gg    , Gg^Es , Gg    , Gg    , Rp    , Rp    , Rp    , Rp    , Rp    , Rp    , Rp    , Rp    , Gg    , Gg    , Gg    , Rp    , Gg    , Gg    , Gg    , Gg    , Gg    , Gg    , Gg    , Gg    , Gg    , Hh    , Hh    , Gg    , Gg    , Gg    , Gg    , Hh    , Hh^Fms, Hh    , Gg^Fms, Gg^Fms, Ww    , Ww    , Ww    , Ww    , Ww    , Gg^Fms, Gg    , Gg^Fms, Gg^Fms
Gg    , Gg    , Gg    , Gg    , Gg    , Gg    , Gg    , Rp    , Gg    , Gg    , Gg    , Rp    , Rp    , Rp    , Rp    , Rp    , Rp    , Rp    , Rp    , Gg    , Gg    , Gg^Es , Gg    , Gg    , Gg^Vh , Gg    , Gg    , Gg    , Gg    , Gg    , Hh    , Hh    , Hh    , Hh    , Gg^Fms, Gg^Fms, Ww    , Ww    , Ww    , Ww    , Ss    , Gg^Fms, Gg^Fms, Gg    , Gg^Fms, Gg^Fms
Gg    , Gg    , Gg    , Gg    , Gg    , Gg^Vl , Gg    , Gg    , Gg    , Gg    , Gg    , Gg    , Gg    , Rp    , Rp    , Rp    , Gg    , Rp    , Rp    , Rp    , Rp    , Gg    , Gg    , Gg    , Gg    , Gg    , Gg    , Gg    , Gg    , Gg    , Gg    , Gg    , Gg    , Gg^Fms, Ww    , Ww    , Ww    , Ww    , Ww    , Ww^Ewl, Ss    , Gg^Fms, Gg^Fms, Gg^Fms, Gg^Fms, Gg^Fms
Gg    , Gg    , Gg    , Gg    , Gg    , Gg^Fms, Gg^Fms, Gg^Fms, Gg^Fms, Gg^Fms, Gg^Fms, Gg    , Gg    , Gg    , Gg    , Gg    , Gg    , Gg    , Gg    , Rp    , Rp    , Rp    , Gg    , Gg    , Gg    , Gg    , Hh    , Gg    , Gg    , Gg    , Gg    , Gg    , Ww    , Ww    , Ww    , Ww    , Ww    , Ww    , Ww    , Ss    , Gg^Fms, Gg^Fms, Gg^Fms, Gg^Fms, Gg^Fms, Gg^Fms
Gg    , Gg    , Gg    , Gg    , Gg    , Gg    , Gg^Fms, Gg^Fms, Gg^Fms, Gg^Fms, Gg^Fms, Gg^Fms, Gg    , Gg    , Gg    , Gg    , Gg    , Gg    , Gg    , Gg    , Rp    , Rp    , Gg    , Gg    , Gg^Fds, Hh^Fds, Hh    , Hh    , Gg    , Gg    , Gg    , Ds    , Ww    , Ww    , Ww    , Ww    , Ww    , Ww    , Ds    , Ds    , Gg^Fms, Gg^Fms, Gg^Fms, Gg^Fms, Gg^Fms, Gg^Fms
Gg    , Gg    , Gg    , Gg    , Gg    , Gg^Fms, Gg    , Gg^Fms, Gg^Fms, Gg^Fms, Gg^Fms, Gg^Fms, Gg    , Gg    , Gg    , Gg    , Gg    , Gg^Es , Gg    , Gg    , Rp    , Rp    , Gg    , Gg    , Gg    , Gg^Fds, Gg    , Hh    , Gg    , Gg    , Gg    , Ww    , Ww    , Ww    , Ww    , Gg    , Gg    , Ds    , Gg    , Gg    , Gg    , Gg    , Gg    , Gg^Fms, Hh^Fms, Hh^Fms
Gg    , Gg    , Gg    , Gg    , Gg    , Gg    , Gg    , Gg    , Gg    , Gg    , Gg    , Gg    , Gg    , Gg    , Gg    , Gg    , Gg    , Gg^Vh , Gg    , Gg    , Rp    , Rp    , Rp    , Gg    , Gg    , Gg    , Gg    , Gg    , Gg    , Gg    , Ww    , Ww    , Ww    , Ww    , Ds    , Gg    , Gg    , Gg    , Gg    , Gg    , Gg    , Gg    , Gg    , Hh    , Hh    , Hh^Fms
Gg    , Gg    , Gg    , Gg    , Gg    , Gg    , Gg    , Gg^Es , Gg    , Gg    , Gg    , Gg    , Gg    , Gg    , Gg    , Gg    , Gg    , Gg    , Gg    , Gg    , Gg    , Rp    , Rp    , Gg    , Gg    , Gg    , Ww    , Ww    , Ww    , Ww    , Ww    , Ww    , Ds    , Ds    , Gg    , Gg    , Gg    , Gg    , Gg    , Gg^Vh , Gg    , Gg^Fms, Hh    , Hh^Fms, Hh^Fms, Hh
Gg    , Gg    , Gg    , Gg^Vh , Gg    , Gg    , Gg    , Gg    , Gg    , Gg    , Ss    , Gg    , Ss    , Gg    , Gg    , Gg    , Gg    , Gg    , Gg    , Gg    , Ce    , Rp    , Rp    , Rp    , Rp    , Gg^Vh , Ww    , Ww    , Ww    , Ww    , Ww    , Ww    , Gg    , Gg    , Gg    , Gg    , Gg    , Gg^Es , Gg    , Gg    , Gg    , Hh    , Hh    , Hh^Fms, Hh    , Hh
Gg    , Gg    , Gg    , Gg    , Gg    , Gg    , Gg    , Gg    , Ss    , Ss    , Gg^Em , Ss    , Gg    , Ss    , Gg    , Ss    , Ss    , Gg    , Gg    , Ce    , 1 Ke  , Ce    , Gg    , Rp    , Wwf   , Wwf   , Ww    , Ww    , Ww    , Ww    , Gg    , Gg    , Gg^Fds, Gg    , Gg^Fds, Gg    , Gg    , Gg    , Gg    , Gg    , Hh    , Hh    , Hh    , Hh    , Hh    , Hh
Gg    , Gg    , Gg    , Gg    , Gg    , Gg    , Ss    , Gg    , Ss    , Ss    , Ss    , Gg    , Ss    , Ss^Vhs, Ss    , Ss    , Ss    , Ss    , Gg^Em , Ce    , Ce    , Ce    , Ww    , Gg    , Wwf   , Wwf   , Wwf   , Ww    , Ds    , Gg    , Gg    , Gg    , Gg^Fds, Gg^Fds, Gg    , Gg    , Gg^Fds, Gg    , Gg    , Gg    , Hh    , Hh    , Hh    , Hh    , Hh    , Hh
Gg    , Gg    , Ww    , Gg    , Gg    , Gg    , Gg    , Ss    , Ss    , Ss    , Ss    , Ss    , Ss    , Ss    , Ww^Ewl, Ss    , Ww    , Ww    , Ww    , Ww    , Ww    , Ww    , Ww    , Ww    , Ww    , Wwf   , Wwf   , Wwf^Es, Rp    , Gg    , Gg    , Gg^Fds, Gg^Fds, Gg^Fds, Gg^Fds, Gg^Fds, Gg    , Gg    , Gg    , Gg    , Hh    , Hh    , Hh    , Mm    , Hh    , Hh
Ww    , Ww    , Ww    , Ww    , Ww    , Ww    , Ww    , Ss    , Ww    , Ww    , Ww    , Ww    , Ww    , Ww^Ewl, Ww    , Ww    , Ww    , Ww    , Ww    , Ww    , Ww    , Ww    , Ww    , Ww    , Gg    , Ww    , Gg    , Rp    , Rp    , Rp    , Rp    , Gg    , Gg    , Gg    , Gg    , Gg    , Gg    , Gg    , Gg    , Gg    , Hh    , Hh    , Hh    , Hh    , Hh    , Hh
Ww    , Ww    , Ww    , Ww    , Ww    , Ww    , Ww    , Ww    , Ww    , Ww    , Ww    , Ww    , Ww    , Ww    , Ww    , Ww    , Ww    , Ww    , Ww    , Ww    , Ss    , Ww    , Ss    , Gg    , Gg    , Gg    , Gg    , Gg    , Gg    , Rp    , Rp    , Rp    , Rp    , Gg    , Gg    , Gg    , Gg    , Gg    , Gg^Es , Gg    , Gg    , Hh    , Hh    , Hh    , Hh    , Hh
Gg    , Gg    , Gg    , Gg    , Ds    , Ww    , Ds    , Ww    , Ww    , Ww    , Ww    , Ww    , Gg    , Ww    , Ds    , Ww    , Gg    , Gg    , Gg    , Gg    , Gg    , Ss    , Gg    , Gg    , Gg    , Gg    , Gg    , Gg    , Gg    , Gg    , Gg    , Rp    , Rp    , Rp    , Rp    , Gg^Vl , Gg    , Gg    , Gg    , Gg    , Gg    , Hh    , Mm    , Hh    , Hh    , Hh
Gg    , Gg    , Gg    , Gg^Es , Gg    , Ds    , Gg    , Ds    , Gg    , Ds    , Ds    , Ds    , Ds    , Gg    , Gg    , Gg    , Ds    , Ds    , Gg    , Gg    , Gg    , Gg    , Gg    , Gg    , Gg    , Gg    , Gg    , Gg^Es , Gg    , Gg    , Gg    , Gg    , Gg    , Rp    , Rp    , Rp    , Rp    , Gg    , Gg    , Gg    , Gg    , Hh    , Hh    , Mm    , Mm    , Hh
Gg    , Gg    , Gg    , Gg    , Gg    , Gg    , Gg    , Gg    , Gg    , Gg    , Gg    , Ds    , Gg    , Gg    , Gg    , Gg    , Gg    , Gg    , Gg    , Gg^Fds, Gg^Fds, Gg    , Gg    , Gg    , Gg^Vh , Gg    , Gg    , Gg    , Co    , Co    , Co    , Gg    , Gg    , Gg    , Gg    , Rp    , Rp    , Gg    , Gg    , Gg    , Gg    , Gg    , Hh    , Hh    , Hh    , Hh
Gg    , Gg    , Gg    , Gg    , Gg^Vh , Gg    , Gg    , Gg    , Gg    , Gg    , Gg^Fms, Gg    , Gg    , Gg    , Gg    , Gg    , Gg    , Gg    , Gg    , Gg^Fds, Gg    , Gg^Fds, Gg    , Gg    , Gg    , Gg    , Gg    , Gg    , Co    , 3 Ko  , Co    , Gg    , Gg    , Gg    , Gg    , Rp    , Rp    , Rp    , Gg    , Gg    , Gg    , Gg    , Gg    , Hh    , Hh    , Hh
Gg    , Gg    , Gg    , Gg    , Gg    , Gg    , Gg    , Gg^Fms, Gg^Fms, Gg^Fms, Gg^Fms, Gg    , Gg    , Gg    , Gg    , Gg^Es , Gg    , Gg    , Gg    , Gg    , Gg    , Gg    , Gg    , Gg    , Gg    , Gg    , Gg    , Gg    , Gg    , Co    , Gg    , Gg    , Gg    , Gg    , Gg    , Gg    , Rp    , Rp    , Gg    , Gg    , Gg    , Gg    , Hh    , Hh    , Hh    , Hh
Gg    , Gg    , Gg    , Gg    , Gg^Fms, Gg^Fms, Gg^Fms, Gg^Fms, Gg^Fms, Gg^Fms, Gg^Fms, Gg^Fms, Gg    , Gg    , Gg    , Gg    , Gg^Vh , Gg    , Gg    , Gg    , Gg    , Gg^Es , Gg    , Gg    , Gg    , Gg    , Gg    , Gg    , Gg    , Gg    , Gg    , Gg    , Gg    , Gg    , Gg^Vl , Gg    , Rp    , Rp    , Rp    , Gg    , Gg    , Hh    , Hh    , Hh    , Hh    , Hh
Gg    , Gg    , Gg    , Gg^Fms, Gg^Fms, Gg    , Hh^Fms, Gg^Fms, Hh    , Gg^Fms, Gg^Fms, Hh^Fms, Hh    , Gg    , Gg    , Gg    , Gg    , Gg    , Gg    , Gg    , Gg    , Gg    , Gg    , Gg    , Gg    , Gg    , Gg^Es , Gg    , Gg    , Gg    , Gg    , Gg    , Gg    , Gg    , Gg    , Gg    , Gg    , Rp    , Rp    , Rp    , Rp    , Hh    , Hh    , Hh    , Hh    , Hh
Gg    , Gg    , Gg    , Gg^Fms, Hh^Fms, Hh    , Hh^Fms, Hh^Fms, Hh^Fms, Hh^Fms, Hh    , Hh    , Hh    , Hh    , Hh    , Hh    , Hh    , Hh    , Gg    , Hh    , Hh    , Gg    , Gg    , Gg    , Gg    , Gg    , Gg    , Gg    , Gg    , Gg    , Gg    , Gg    , Hh    , Gg    , Hh    , Hh    , Gg    , Gg    , Hh    , Rp    , Rp    , Gg    , Hh    , Hh    , Hh    , Hh
Gg    , Gg    , Gg    , Hh    , Hh    , Hh^Fms, Hh    , Hh    , Mm    , Hh    , Hh    , Hh    , Hh    , Hh    , Hh    , Hh    , Hh    , Hh    , Hh    , Hh    , Hh    , Gg    , Hh    , Hh    , Hh    , Gg    , Gg    , Gg    , Gg    , Gg    , Gg    , Gg    , Hh    , Hh    , Hh    , Hh    , Hh    , Hh    , Hh    , Rp    , Rp    , Gg    , Hh    , Hh    , Hh    , Hh
Gg    , Gg    , Hh    , Hh    , Hh    , Hh    , Hh    , Hh    , Hh    , Hh    , Hh    , Hh    , Mm    , Hh    , Hh    , Hh    , Hh    , Hh    , Hh    , Hh    , Hh    , Hh    , Hh    , Hh    , Hh    , Hh    , Hh    , Gg    , Gg    , Gg    , Gg    , Hh    , Hh    , Hh    , Hh    , Hh    , Hh    , Hh    , Hh    , Rp    , Rp    , Hh    , Hh    , Hh    , Mm    , Mm
