border_size=1
usage=map

Gs^Fdf, Gs^Fdf, Gs^Fdf, Gs^Fdf, Gs^Fdf, Gs^Fdf, Gs^Fdf, Gs^Fdf, Gs^Fdf, Gs^Fdf, Gs^Fdf, Gs^Fdf, Gs^Fdf, Gs^Fdf, Gs^Fdf, Ss    , Ss    , Ww    , Gs    , Ss    , Gs^Fdf, Gs^Fdf, Gs^Fdf, Gs^Fdf, Gs^Fdf, Gs^Fdf, Gd^Fdf, Gs^Fdf, Re    , Gd    , Gs^Fdf, Gd    , Gd    , Gs^Fdf, Gs^Fmf, Gs^Fdf, Gs^Fdf, Gs^Fdf, Gs^Fdf, Gs^Fdf, Gs^Fdf, Gs^Fdf, Gs^Fdf, Gs^Fdf, Gs^Fdf, Gs^Fdf, Gs^Fdf, Gs^Fdf
Gs^Fdf, Gs^Fdf, Gd^Fdf, Gd^Fdf, Gd^Fdf, Gd^Fdf, Gd^Fdf, Gs^Fdf, Gs^Fdf, Gs^Fdf, Gs^Fdf, Gs^Fdf, Gs^Fdf, Gs^Fdf, Ss    , Ss    , Gs^Fmf, Ww    , Gs^Fmf, Gs^Fmf, Ss    , Ss    , Gs^Fmf, Gs^Fdf, Gs^Fdf, Gd^Fdf, Gd^Fdf, Gd    , Re    , Gd    , Gd    , Gs^Fdf, Gd    , Gd    , Gd    , Gs^Fmf, Gd    , Gd    , Gd    , Gs^Fdf, Gs^Fdf, Gs^Fdf, Gs^Fdf, Gs^Fdf, Gs^Fdf, Gs^Fdf, Gs^Fdf, Gs^Fdf
Gs^Fdf, Gs^Fdf, Gd^Fdf, Gs^Fdf, Gd^Fdf, Gd^Fdf, Gd^Fdf, Gs^Fdf, Gd^Fdf, Gs^Fdf, Gs^Fmf, Gs^Fdf, Gs^Fdf, Ss    , Gs^Fmf, Ss    , Ss    , Wwf   , Ww    , Ss    , Gs^Fmf, Ss    , Ss    , Gs^Fmf, Gs^Fmf, Gd    , Gd^Fmf, Gd    , Re    , Gd^Es , Gd    , Gd    , Gs^Fdf, Gs^Fdf, Gs^Fdf, Gs^Fdf, Gs    , Gs^Fmf, Gs^Fmf, Gs^Fdf, Gs^Fdf, Gs^Fdf, Gd    , Gs^Fdf, Gs^Fdf, Gs^Fmf, Gs^Fdf, Gs^Fdf
Gs^Fdf, Gs^Fdf, Gd^Fdf, Gs^Fdf, Gd    , Gd    , Gs^Fdf, Gs^Fdf, Gs^Fdf, Gs^Fdf, Gs^Fdf, Gs^Fdf, Gs^Fdf, Gs^Fmf, Gs^Fmf, Ss    , Gs^Fmf, Gs^Fmf, Ww    , Ss    , Ss    , Gs^Fmf, Ss    , Gs^Fmf, Gs    , Gs^Fmf, Gs    , Gd    , Re    , Gs^Fmf, Gs^Fmf, Gd    , Gs^Fmf, Gd    , Gs^Fmf, Gs^Fmf, Gs    , Gs    , Gs^Fmf, Gs^Fmf, Gd    , Gs^Fmf, Gs^Fdf, Gs^Fmf, Gs^Fdf, Gs^Fdf, Gs^Fdf, Gs^Fdf
Gs^Fdf, Gs^Fdf, Gs^Fdf, Gs^Fdf, Gs^Fdf, Gd^Fdf, Gs    , Gd^Fdf, Gs^Fdf, Gs^Fmf, Gs^Fdf, Gs^Fdf, Gs^Fmf, Ss    , Gs^Fmf, Gs^Fmf, Ss    , Gs^Fmf, Gs^Fp , Ww    , Gs    , Ss    , Gs^Fmf, Gs^Fmf, Ss    , Gs    , Gs^Fmf, Gs    , Gd    , Re    , Re    , Gs^Fmf, Gs    , Gs^Fmf, Gs^Fp , Gs^Fmf, Ss    , Gs^Fmf, Gs^Fmf, Gs^Fmf, Gd    , Gs^Fmf, Gs^Fmf, Gs^Fdf, Gs^Fdf, Gs^Fdf, Gs^Fdf, Gs^Fdf
Gs^Fdf, Gs^Fdf, Gs^Fdf, Gs^Fdf, Gs^Fdf, Gs    , Gs^Fdf, Gd^Fdf, Gd^Fdf, Gs^Fdf, Gs^Fdf, Gs^Fdf, Ss    , Gs^Fmf, Gs^Fmf, Ss    , Gs^Fmf, Ss    , Ss^Vhs, Ww    , Ww    , Ss    , Ss    , Gs^Fmf, Gs^Fmf, Gs^Fmf, Gs^Fmf, Gs    , Gs    , Gd    , Re    , Gs    , Gs    , Ss    , Ss    , Ss    , Gs^Fmf, Gs^Fmf, Gs^Fmf, Gs^Fmf, Hh^Vhh, Gs^Fmf, Gs^Fmf, Gs^Fmf, Gs^Fmf, Gs^Fdf, Gs^Fdf, Gs^Fdf
Gd^Fdf, Gd^Fdf, Gd^Fdf, Gd    , Gs^Fdf, Gs    , Gd    , Gs    , Gd^Fdf, Gs^Fdf, Gs^Fdf, Gs^Fmf, Gg    , Gs    , Chr   , Gs    , Chr   , Gs^Fmf, Ss    , Gs^Fmf, Wwf   , Gs^Fmf, Gd    , Ss    , Gs    , Gs    , Ss    , Gs^Fmf, Gs^Fmf, Gs^Fmf, Re    , Gs^Vo , Gs    , Gs    , Ss    , Gs^Fmf, Gs^Fmf, Gs^Fmf, Gs    , Hh^Fdf, Gg^Fdf, Hh    , Hh^Fdf, Gs^Fdf, Gs^Fdf, Gs^Fdf, Gs^Fdf, Gs^Fdf
Gd^Fdf, Gd    , Gd    , Gd^Fmf, Gd^Fdf, Gd^Fmf, Gd    , Gs    , Gd^Fdf, Gs^Fdf, Gs^Fmf, Gd^Fmf, Gd^Fmf, Ss    , Gs^Fmf, 3 Khr , Gs    , Re    , Re    , Re    , Ss    , Wwf   , Ss    , Ss    , Gd^Vo , Gs    , Gs^Fmf, Gs^Fmf, Gs^Fmf, Gs    , Re    , Gs    , Ss    , Ss    , Ss    , Gs^Fp , Ss    , Gs    , Gs    , Chr   , 4 Khr , Hh^Fdf, Hh^Fdf, Gs^Fdf, Gs^Fdf, Gs^Fdf, Gs^Fdf, Gs^Fmf
Gd^Fdf, Gd    , Gd^Fdf, Gd^Fdf, Gd^Fdf, Gd    , Gd^Vo , Gd^Fmf, Gs^Fdf, Gs^Fmf, Ss    , Gd^Fmf, Gg    , Gd^Fmf, Gd^Fmf, Ss    , Ss    , Re    , Ss    , Ss    , Ss    , Ww    , Ww    , Ss    , Ss    , Ss    , Ss    , Gs^Fmf, Gs    , Gs^Es , Re    , Gs    , Ss    , Gs    , Ss    , Gs    , Gd    , Gs    , Gs    , Hh    , Chr   , Gs^Fmf, Hh^Fdf, Hh^Fdf, Gs^Fmf, Gs^Fdf, Gs^Fdf, Gs^Fdf
Gd    , Gd    , Gd^Fdf, Gd    , Gd^Es , Gd    , Gs    , Gs    , Gs^Fmf, Gs^Fdf, Gs^Fmf, Gd^Fmf, Ss    , Ss^Vhs, Gs    , Gs    , Gs    , Gs    , Gs    , Ss    , Gd    , Ww    , Ww    , Ww    , Ss    , Ss    , Gs    , Ss    , Ss    , Gs    , Re    , Gs    , Gs    , Ss    , Gs    , Gs    , Gd    , Gd    , Ss    , Ss    , Hh    , Gg^Fdf, Hh    , Hh    , Gs^Fmf, Gs^Fmf, Gs^Fdf, Gs^Fmf
Gd    , Gd^Fdf, Gd    , Gd^Fdf, Gd    , Gs    , Gs    , Gs    , Gs^Fdf, Gs^Fdf, Ss    , Gs^Fmf, Gs^Fmf, Ss    , Gs    , Gd    , Gs    , Gd^Fp , Gs    , Ss    , Gd    , Gd    , Ww    , Ss    , Ss    , Gd    , Gs    , Gs    , Ss    , Gd    , Gd    , Re    , Re    , Gs    , Ss    , Ss    , Gs    , Gd    , Ss    , Gs    , Ss^Vhs, Hh^Fdf, Hh^Fdf, Gs^Fmf, Gs^Fmf, Hh^Fp , Gs^Fmf, Gs^Fmf
Gd    , Gd    , Gd    , Gd    , Gs    , Gs    , Ss    , Ss    , Ss    , Ss    , Gs^Fmf, Ss    , Gg    , Ss    , Ss    , Gs    , Ss    , Ss    , Ss    , Gs    , Ss    , Gd    , Ss    , Ww    , Ss    , Gs    , Gs^Fmf, Ss    , Ss^Vhs, Gd    , Gd    , Ss    , Re    , Re    , Ss    , Ss    , Ss    , Gd    , Gs    , Ss    , Ss    , Hh    , Hh    , Hh^Fdf, Gs^Fmf, Hh^Fp , Gs^Fdf, Gs^Fdf
Re    , Gd    , Re    , Re    , Re    , Gs    , Re    , Gs    , Ss    , Gs    , Gs^Fmf, Ss    , Gs^Fmf, Ss    , Gs    , Gs    , Ss    , Gg    , Ss    , Gd^Fp , Gg    , Ss    , Gd    , Ww    , Ww    , Ww    , Ww    , Ss    , Ww    , Re    , Re    , Ss    , Re    , Gs    , Ss    , Ss    , Gs^Fmf, Ss    , Gs    , Ss    , Gs    , Gs^Fmf, Gd    , Gs^Fmf, Gs^Fmf, Gs^Fmf, Gs^Fdf, Gs^Fdf
Gd    , Re    , Gd    , Gd    , Gd^Es , Re    , Gs    , Re    , Re    , Gs    , Re    , Gs    , Gs    , Gs^Fmf, Gs    , Gs    , Gs^Vo , Ss    , Gs    , Ss    , Ss    , Gs    , Ss    , Gd    , Re    , Ww    , Re    , Ww    , Chr   , Ww    , Ww    , Re    , Ss    , Ss    , Ss    , Ss    , Ss    , Gs    , Ss    , Gs    , Gd    , Gs    , Gs^Fmf, Gs^Fmf, Gs^Fmf, Gs^Fmf, Gs^Fmf, Gs^Fdf
Gd    , Gd    , Gs^Fmf, Gd    , Gd    , Gd    , Gs    , Gs    , Gs    , Re    , Gd    , Re    , Re    , Gs    , Chr   , Ss    , Re    , Gs    , Re    , Gs^Es , Re    , Gs    , Re    , Re    , Re    , Re    , Re    , Chr   , Khr   , Chr   , Re    , Ss    , Gs    , Gs^Fmf, Gs^Fp , Ss    , Gs    , Gs    , Gs    , Gs    , Gd    , Gs^Fmf, Gs^Fmf, Gs^Fmf, Gs^Fmf, Gs^Fmf, Gs^Fdf, Gs^Fdf
Gd    , Gd    , Ce    , Ce    , 1 Ke  , Ce    , Ce    , Gs    , Gs    , Gs    , Gd    , Gd    , Gd^Fmf, Re    , Re    , Re    , Gd    , Re    , Gd    , Re    , Gs    , Re    , Ss    , Gs    , Gd    , Ww    , Re    , Re    , 2 Khr , Re    , Re    , Ww    , Ww    , Gs    , Gs    , Ss    , Ss    , Gs    , Ss    , Gs    , Gd    , Gd    , Gs^Fmf, Gs^Fmf, Gs^Fmf, Gs^Fmf, Gs^Fdf, Gs^Fdf
Gd    , Gd    , Gd    , Gd    , Ce    , Gs    , Gd    , Gs    , Gs    , Gs    , Gd^Fmf, Gd^Fmf, Gd^Fmf, Gs    , Chr   , Gs    , Gd^Fmf, Gd^Fp , Gs    , Gd^Fmf, Gs^Fmf, Gs    , Ss    , Ss^Vhs, Gs    , Ww    , Re    , Chw   , Chw   , Chw   , Wwf   , Ss    , Ww    , Ss^Vhs, Gs    , Gs    , Gs    , Gs    , Ss    , Gs    , Gs^Fmf, Gd    , Gs^Fmf, Gs^Fmf, Gs^Fmf, Gs^Fdf, Gs^Fdf, Gs^Fdf
Gd    , Gd    , Gs^Fmf, Gs^Fmf, Gs^Fmf, Gd    , Gd    , Gs^Fdf, Gd    , Gs    , Gs    , Gd^Fmf, Gs    , Ss    , Ss    , Gs    , Ss    , Gs^Fp , Ss    , Gg    , Ss    , Gs    , Gs    , Ss    , Gs    , Ss    , Ss    , Ww    , Ww    , Wwf   , Re    , Re    , Ss    , Ww    , Gd    , Ss    , Ss    , Ss    , Ss    , Gs    , Gs^Fmf, Gs^Fmf, Gs^Fmf, Gd    , Gs^Fmf, Gs^Fdf, Gs^Fdf, Gs^Fmf
Gs^Fdf, Gd    , Gs^Fdf, Gs^Fmf, Gd    , Gd    , Gd    , Gd    , Gs^Fdf, Gs^Fdf, Gs    , Gs    , Gs    , Gs    , Gs    , Gs    , Ss    , Ss    , Ss    , Gs    , Ss    , Ss    , Ss    , Gd    , Gd    , Gs    , Gs    , Ss^Vhs, Ss    , Ss    , Gs    , Re    , Gs    , Ww    , Wwf   , Ss    , Ww    , Gs    , Ss    , Ss    , Gs^Fmf, Gs^Fmf, Gs^Fmf, Gs^Fmf, Gs^Fmf, Gs^Fmf, Gs^Fdf, Gs^Fdf
Gg    , Gs^Fdf, Gs^Fdf, Gd    , Gd    , Gg^Vo , Gd    , Gd    , Gs^Fdf, Gs^Fdf, Gs^Fmf, Ss    , Gs    , Gs    , Ss    , Gs^Fmf, Gs    , Ss    , Ww    , Ss    , Ss    , Ss    , Ss    , Gs    , Ss    , Gs    , Ss    , Ss    , Gs    , Gs    , Gs    , Re    , Re    , Gd^Vo , Ww    , Ww    , Ww    , Ww    , Ww    , Ss    , Ss    , Gs^Fmf, Gs^Fmf, Gs^Fmf, Gs^Fmf, Gs^Fdf, Gs^Fmf, Gs^Fdf
Gs^Fdf, Gs^Fdf, Gs^Fdf, Gs^Fdf, Gd    , Gd    , Gd    , Gs^Fdf, Gs^Fdf, Gs^Fdf, Gs^Fmf, Gs^Fmf, Gs    , Gs    , Gs^Vo , Ss    , Gd    , Gs    , Ss    , Ss    , Ss    , Ss    , Gg    , Gs    , Ss    , Gs    , Ss    , Ss    , Gd    , Ss    , Ss    , Gs    , Re    , Gs    , Ss    , Ss    , Gs    , Ss    , Ss    , Ww    , Ww    , Ss    , Ss    , Gs    , Gs^Fmf, Gs^Fdf, Gs^Fdf, Gs^Fdf
Gd^Fdf, Gd^Fdf, Gd^Fdf, Gd^Fdf, Gs^Fdf, Gd^Fdf, Gs^Fdf, Gd    , Gs^Fdf, Gs^Fdf, Gs^Fmf, Gs^Fdf, Gs^Fmf, Gs    , Ss    , Gs    , Ss    , Ss    , Ss    , Gs    , Ss    , Ss    , Ss    , Ss    , Ss    , Ss    , Ss    , Ss    , Ss    , Gs    , Gs    , Gs    , Re    , Re    , Ss    , Ss    , Gs    , Gs    , Ss    , Ww    , Ww    , Gd^Fmf, Ss    , Gs^Fmf, Gs^Fmf, Gs^Fdf, Gs^Fdf, Gs^Fdf
Gs^Fdf, Gs^Fdf, Gs^Fdf, Gd    , Gs^Fdf, Gs^Fdf, Gs^Fdf, Gs^Fdf, Gs^Fdf, Gs^Fdf, Gd^Fdf, Gs^Fmf, Gd    , Gs    , Gs    , Gs    , Gs    , Gs    , Gs    , Ss    , Gs    , Gs    , Ss    , Gg    , Ss    , Ss    , Gd^Fp , Ss    , Ss    , Ss    , Gs    , Gd    , Gs    , Re    , Re    , Ss    , Gs    , Gs^Es , Ss    , Gd^Fmf, Ww    , Gd^Fmf, Ss    , Gs^Fmf, Gs^Fmf, Gs^Fmf, Gs    , Gs^Fdf
Gs^Fdf, Gd^Fdf, Gs^Fdf, Gs^Fdf, Gs^Fdf, Gs^Fdf, Gs^Fdf, Gs^Fmf, Gs^Fdf, Gs^Fdf, Gd^Fdf, Gd    , Gd    , Gs^Fmf, Gd    , Gs^Fmf, Gs    , Ss    , Re    , Ss    , Ss    , Ss    , Gs    , Ss    , Ss    , Ss    , Gd^Fp , Ss    , Ss    , Gs    , Ss    , Gs    , Gs    , Ss    , Re    , Gs    , Gs    , Ss    , Gs^Fmf, Ss^Vhs, Ww    , Ss    , Gd^Fmf, Gs^Fmf, Gs    , Gs    , Gs^Fdf, Gs^Fdf
Gs^Fdf, Gs^Fdf, Gd    , Gs^Fdf, Gd^Fdf, Gd    , Gs^Fdf, Gs^Fdf, Gs^Fdf, Gd^Fdf, Gd^Fmf, Gd^Fmf, Gd^Fmf, Gd    , Gd    , Gs    , Gs^Fmf, Gs    , Gs    , Re    , Gs    , Gs    , Ss    , Gs    , Hh    , Hh    , Hh^Fmf, Gd    , Gs    , Gs    , Gs    , Ss    , Gs    , Gs    , Re    , Ss    , Gs^Fmf, Ss    , Ss    , Gs^Fmf, Ww    , Ww    , Gd^Fmf, Gd^Fmf, Gs^Fmf, Gs    , Gs    , Gs^Fdf
Gs^Fdf, Gs^Fdf, Gs^Fdf, Gd^Fdf, Gd^Fdf, Gs^Fdf, Gs^Fdf, Gs^Fdf, Gs^Fdf, Gd^Fdf, Gd^Fdf, Gd^Fmf, Gd^Fmf, Gd    , Gd^Fmf, Gd    , Gs^Fmf, Gs^Fmf, Gs^Fmf, Gs    , Ss^Vhs, Gs    , Gs    , Hh    , Hh^Fdf, Hh^Fmf, Hh^Fdf, Hh^Vhh, Hh    , Gs    , Ss    , Ss    , Ss    , Ss    , Re    , Gs    , Ss    , Ss    , Gs^Fmf, Ss    , Ss    , Ww    , Ww    , Gs    , Gs    , Gs    , Gs    , Gs^Fdf
Gs^Fdf, Gs^Fdf, Gs^Fdf, Gs^Fdf, Gs^Fdf, Gs    , Gd    , Gs^Fdf, Gs^Fdf, Gs^Fdf, Gs^Fdf, Gd^Fmf, Gs^Fdf, Gs^Fmf, Gs^Fmf, Gd    , Re    , Gs^Fmf, Gs^Fmf, Ss    , Gs    , Gs^Fmf, Gd    , Hh^Fmf, Hh^Fdf, Hh^Fdf, Hh^Fdf, Hh^Fmf, Hh^Fmf, Gs    , Gs    , Gs    , Gs    , Gs    , Re    , Gs    , Gs^Es , Gs^Fmf, Chr   , Ss    , Gs^Fmf, Gd^Fmf, Gd^Fmf, Ww    , Ww    , Gs    , Gs^Fdf, Gs^Fdf
Gs^Fdf, Gs^Fdf, Gd^Fdf, Gs^Fdf, Gs    , Gd^Vc , Gd^Fdf, Gs^Fdf, Gd^Fdf, Gs^Fmf, Gs^Fdf, Gs^Fdf, Gs    , Gd    , Gd^Fdf, Gd^Fmf, Re    , Gs^Fmf, Chr   , Gs^Fmf, Gd^Fmf, Gd    , Gs^Fmf, Gs^Fmf, Hh    , Hh^Fdf, Hh^Fdf, Hh    , Gs^Fmf, Gs    , Gs^Fmf, Gs^Fmf, Gd    , Re    , Gd    , Gs    , Gd    , Gs    , 5 Khr , Gs^Fmf, Gd^Fmf, Gs    , Gd^Fmf, Gs    , Ww    , Gs    , Gs^Fdf, Gs^Fdf
Gs^Fdf, Gs^Fdf, Gd^Fdf, Gs^Fdf, Gs^Fdf, Gd^Fdf, Gs^Fdf, Gs^Fdf, Gd^Fdf, Gs^Fdf, Gs^Fdf, Gs^Fdf, Gs^Fdf, Gs^Fmf, Gd^Fdf, Gd^Fmf, Gs^Fmf, 6 Khr , Gd^Fmf, Gd    , Gd^Fmf, Gs^Fmf, Gs^Fmf, Gs^Fmf, Gs^Fmf, Hh^Fdf, Gs^Fdf, Gs^Fdf, Gd^Fmf, Gd    , Gd^Fmf, Gd    , Gd^Vo , Re    , Gs^Fmf, Gd^Fmf, Gd^Fmf, Gs^Fmf, Gd^Fdf, Chr   , Gd^Fmf, Gd^Fmf, Gs^Fdf, Gs    , Gs^Fdf, Ww    , Gs    , Gs^Fdf
Gs^Fdf, Gs^Fdf, Gs^Fdf, Gd^Fdf, Gs^Fdf, Gd^Fmf, Gs^Fdf, Gs^Fdf, Gd^Fdf, Gs^Fdf, Gs^Fdf, Gd^Fmf, Gd    , Gd    , Gs^Fdf, Gd^Fdf, Gs^Fdf, Chr   , Gd    , Gd^Fmf, Gs^Fmf, Gd    , Gs^Fmf, Gs^Fmf, Gs    , Gs^Fmf, Gd^Fmf, Gd^Fdf, Gd^Fmf, Gd^Fmf, Gd^Fmf, Gd^Fmf, Gd    , Re    , Gs    , Gs    , Gd^Fdf, Gd^Fdf, Gd^Fmf, Gd^Fmf, Gd^Fdf, Gs^Fdf, Gs^Fdf, Gs^Fdf, Gs^Fdf, Ww    , Gs    , Gs
Gs^Fdf, Gs^Fdf, Gs^Fdf, Gs^Fdf, Gs^Fdf, Gd^Fdf, Gs^Fdf, Gs^Fdf, Gd^Fdf, Gs^Fdf, Gs^Fdf, Gs^Fdf, Gs    , Gd^Vl , Gd    , Gs^Fdf, Gs^Fdf, Gs^Fdf, Gs^Fdf, Gs^Fmf, Gs^Fmf, Gs^Fmf, Gd    , Gs^Fdf, Gd^Fdf, Gd    , Gs^Fmf, Gd^Fmf, Gd^Fmf, Gd^Fmf, Gd    , Gs^Fmf, Gs^Fmf, Re    , Gs^Fmf, Gd    , Gd^Fdf, Gs^Fmf, Gd^Fdf, Gs^Fdf, Gd^Fdf, Gs^Fdf, Gs^Fdf, Gs^Fdf, Gs^Fdf, Ww    , Gs    , Gs
Gs^Fdf, Gs^Fdf, Gs^Fdf, Gs^Fdf, Gs^Fdf, Gs^Fdf, Gs^Fdf, Gd^Fdf, Gd^Fdf, Gs^Fdf, Gs^Fdf, Gs^Fdf, Gs^Fdf, Gd^Fdf, Gs^Fdf, Gs^Fdf, Gs^Fdf, Gs^Fdf, Gs^Fdf, Gs^Fdf, Gs^Fdf, Gs^Fdf, Gs^Fdf, Gd    , Gs^Fdf, Gd^Fdf, Gd^Fdf, Gd    , Gs^Fdf, Gd    , Gs^Fdf, Gd^Fmf, Gd    , Re    , Re    , Gs^Fmf, Gd^Fdf, Gd^Fdf, Gs^Fdf, Gd^Fdf, Gd^Fdf, Gs^Fdf, Gd^Fdf, Gs    , Gs    , Ww    , Ww    , Gs
Gs^Fdf, Gs^Fdf, Gs^Fdf, Gs^Fdf, Gs^Fdf, Gs^Fdf, Gs^Fdf, Gs^Fdf, Gs^Fdf, Gs^Fdf, Gs^Fdf, Gs^Fdf, Gs^Fdf, Gs^Fdf, Gs^Fdf, Gs^Fdf, Gs^Fdf, Gs^Fdf, Gs^Fdf, Gs^Fdf, Gs^Fdf, Gs^Fdf, Gs^Fdf, Gs^Fdf, Gs^Fdf, Gd    , Gs^Fdf, Gd^Fdf, Gs^Fdf, Gd^Fdf, Gs^Fdf, Gd    , Gd    , Gd    , Re    , Gd    , Gd    , Gd^Fdf, Gd^Fdf, Gd^Fdf, Gd^Fdf, Gd^Fdf, Gd^Fdf, Gd^Fdf, Gs^Fdf, Gs    , Gs    , Ww
