border_size=1
usage=map

Xu     , Xu     , Xu     , Xu     , Xu     , Xu     , Xu     , Xu     , Xu     , Xu     , Xu     , Xu     , Xu     , Xu     , Xu     , Woy    , Xu     , Xu     , Xu     , Xu     , Xu     , Xu     , Xu     , Xu     , Xu     , Xu     , Xu     , Xu     , Xu     , Xu     , Xu     , Xu     , Xu     , Xu     , Xu     , Xu     , Xu     , Xu     , Xu     , Xu     , Xu     , Xu     , Xu     , Uu     , Uu     , Uu
Xu     , Xu     , Xu     , Xu     , Xu     , Xu     , Xu     , Xu     , Xu     , Xu     , Xu     , Xu     , Xu     , Xu     , Xu     , Woy    , Xu     , Xu     , Xu     , Xu     , Xu     , Xu     , Xu     , Xu     , Xu     , Xu     , Xu     , Xu     , Xu     , Xu     , Xu     , Xu     , Xu     , Xu     , Xu     , Xu     , Xu     , Ce     , Xu     , Xu     , Uu     , Uu^Vu  , Uu     , Uu     , Uu     , Uu
Xu     , Xu     , Xu     , Xu     , Xu     , Xu     , Xu     , Xu     , Xu     , Xu     , Xu     , Xu     , Xu     , Xu     , Xu     , Woy    , Xu     , Xu     , Xu     , Uu^Uf  , Xu     , Xu     , Xu     , Xu     , Xu     , Xu     , Xu     , Xu     , Xu     , Xu     , Ur     , Xu     , Uu     , Xu     , Xu     , Xu     , Ce     , Ce     , 1 Ke   , Ce     , Ur     , Uu     , Ur     , Uh     , Wwy    , Wwy
Uu^Br\ , Xu     , Xu     , Xu     , Xu     , Xu     , Xu     , Xu     , Xu     , Xu     , Xu     , Xu     , Xu     , Xu     , Wwy    , Wwy    , Xu     , Xu     , Uh     , Uh     , Xu     , Xu     , Uh     , Xu     , Xu     , Xu     , Uu^Uf  , Xu     , Xu     , Uh     , Xu     , Ur     , Xu     , Uu^Vu  , Ur     , Ur     , Xu     , Xu     , Ce     , Ce     , Ur     , Ur     , Wwy    , Wwy    , Xu     , Xu
Xu     , Uu^Br\ , Uu^Br\ , Xu     , Uu^Vud , Xu     , Xu     , Xu     , Cud    , Cud    , Cud    , Xu     , Xu     , Wwy    , Xu     , Xu     , Xu     , Uh     , Xu     , Uu^Uf  , Uu^Uf  , Uu^Uf  , Uu^Uf  , Uu^Uf  , Uu^Uf  , Ur     , Xu     , Ur     , Ur     , Uu     , Xu     , Xu     , Xu     , Xu     , Xu     , Xu     , Xu     , Xu     , Xu     , Ur     , Ur^Es  , Xu     , Wwy    , Xu     , Xu     , Xu
Xu     , Xu     , Xu     , Uu^Br\ , Uu^Br\ , Ur     , Ur^Es  , Cud    , Cud    , 2 Kud  , Cud    , Cud    , Xu     , Wwy    , Xu     , Xu     , Xu     , Xu     , Uu^Uf  , Uu^Vu  , Uu^Uf  , Uu     , Uu^Uf  , Uu^Uf  , Uu^Uf  , Xu     , Xu     , Xu     , Xu     , Xu     , Xu     , Xu     , Xu     , Xu     , Xu     , Xu     , Xu     , Xu     , Uh     , Uu     , Uu     , Uu     , Wwy    , Xu     , Xu     , Xu
Xu     , Xu     , Xu     , Xu     , Xu     , Ur^Br\ , Ur^Br\ , Ur     , Ur     , Cud    , Xu     , Xu     , Xu     , Wwy    , Wwfy   , Xu     , Xu     , Uh     , Xu     , Uu^Uf  , Uu^Uf  , Uu^Uf  , Uu^Uf  , Uu^Uf  , Uu^Uf  , Xu     , Xu     , Xu     , Xu     , Xu     , Xu     , Xu     , Uu     , Xu     , Uu     , Uu     , Uu     , Uh     , Uu     , Uu^Vu  , Uu     , Uh     , Wwy    , Xu     , Xu     , Xu
Xu     , Xu     , Xu     , Xu     , Xu     , Xu     , Xu     , Ur^Br\ , Ur^Br\ , Uu^Br/ , Uu^Br\ , Xu     , Xu     , Xu     , Xu     , Wwfy   , Ur     , Xu     , Xu     , Uu^Uf  , Uu^Uf  , Uu^Uf  , Ur     , Uu^Uf  , Xu     , Uh     , Xu     , Xu     , Xu     , Xu     , Xu     , Xu     , Uh     , Uu     , Uu^Es  , Xu     , Uh     , Uu     , Xu     , Uu     , Xu     , Wwfy   , Wwy    , Xu     , Xu     , Xu
Xu     , Xu     , Xu     , Xu     , Uu     , Xu     , Xu     , Xu     , Xu     , Uh     , Uh     , Uu^Br\ , Uu^Br\ , Xu     , Uh     , Uh     , Ur     , Xu     , Xu     , Xu     , Xu     , Xu     , Ur     , Xu     , Xu     , Xu     , Xu     , Xu     , Xu     , Xu     , Uh     , Uh     , Uu^Vu  , Uu     , Xu     , Uu     , Uh     , Xu     , Xu     , Wwfy   , Wwy    , Wwy    , Xu     , Xu     , Xu     , Xu
Xu     , Xu     , Uu     , Uu     , Uu     , Uu     , Xu     , Xu     , Xu     , Xu     , Xu     , Uh     , Uu     , Uu^Br\ , Uu^Br\ , Uh     , Ur     , Ur     , Uh     , Xu     , Xu     , Xu     , Uh     , Xu     , Xu     , Xu     , Xu     , Xu     , Xu     , Xu     , Uu     , Uu     , Xu     , Uu     , Uh     , Uh     , Uu     , Xu     , Wwy    , Wwy    , Wwy    , Wwy    , Xu     , Xu     , Xu     , Xu
Xu     , Xu     , Xu     , Uu     , Uu     , Xu     , Xu     , Xu     , Xu     , Xu     , Uu^Vud , Uu     , Ur     , Ur     , Ur     , Ur^Br\ , Ur^Br\ , Ur     , Xu     , Xu     , Uh     , Uh     , Xu     , Xu     , Xu     , Xu     , Xu     , Xu     , Xu     , Uu     , Uh     , Uu^Es  , Uu     , Uu     , Xu     , Uu     , Xu     , Wwy    , Xu     , Xu     , Xu     , Xu     , Xu     , Xu     , Xu     , Xu
Xu     , Xu     , Qxu    , Qxu    , Qxu    , Qxu    , Xu     , Xu     , Qxu    , Xu     , Qxu    , Uu     , Uu     , Ur^Es  , Uu     , Ur     , Uu     , Uu^Br\ , Uu^Br\ , Uu     , Uu^Vud , Uh     , Uh     , Xu     , Xu     , Xu     , Xu     , Xu     , Wwfy   , Uu     , Wwfy   , Uu     , Xu     , Uu     , Xu     , Xu     , Wwy    , Wwy    , Xu     , Xu     , Xu     , Xu     , Xu     , Xu     , Xu     , Xu
Qxu    , Qxu    , Qxu    , Qxu    , Qxu    , Qxu    , Qxu    , Qxu    , Qxu    , Qxu    , Xu     , Qxu    , Xu     , Uh     , Xu     , Xu     , Ur     , Uu     , Uu^Br| , Uu^Br\ , Uu^Br\ , Uu^Es  , Uu     , Uh     , Uu     , Xu     , Xu     , Xu     , Wwfy   , Wwfy^Es, Wwfy   , Wwfy   , Xu     , Xu     , Xu     , Xu     , Wwy    , Xu     , Xu     , Xu     , Xu     , Xu     , Xu     , Xu     , Xu     , Xu
Qxu    , Qxu    , Qxu    , Qxu    , Qxu    , Qxu    , Qxu    , Qxu    , Qxu    , Qxu    , Qxu    , Qxu    , Xu     , Xu     , Xu     , Ur     , Ur     , Uu     , Uu^Br| , Uh     , Uh     , Uu     , Uu     , Uu     , Uu     , Uu     , Uu     , Wwfy   , Wwfy   , Xu     , Wwy    , Wwy    , Wwy    , Wwy    , Wwy    , Wwy    , Xu     , Xu     , Xu     , Xu     , Xu     , Xu     , Xu     , Xu     , Xu     , Xu
Xu     , Qxu    , Xu     , Qxu    , Xu     , Qxu    , Xu     , Xu     , Xu     , Qxu    , Qxu    , Qxu    , Uh     , Uh     , Uh     , Xu     , Xu     , Ur     , Ur^Br| , Uh     , Uh     , Uh     , Uh     , Ur^Es  , Ur     , Uu     , Uu     , Uh     , Xu     , Wwy    , Wwy    , Wwy    , Wwy    , Wwy    , Wwy    , Wwy    , Wwy    , Xu     , Xu     , Xu     , Xu     , Xu     , Xu     , Xu     , Xu     , Xu
Xu     , Xu     , Xu     , Xu     , Xu     , Xu     , Xu     , Xu     , Xu     , Xu     , Ur     , Uh     , Uu     , Uh     , Uu^Vud , Uu     , Uu^Br/ , Uu^Br/ , Ur     , Uu     , Uu     , Uu     , Uu     , Ur     , Uu     , Uu     , Xu     , Qxu    , Qxu    , Qxu    , Qxu    , Wwy    , Wwy    , Xu     , Xu     , Wwy    , Wwy    , Wwy    , Xu     , Xu     , Xu     , Xu     , Xu     , Xu     , Xu     , Xu
Xu     , Xu     , Xu     , Xu     , Wwy    , Xu     , Wwy    , Wwy    , Wwy    , Wwfy   , Wwfy   , Ur^Es  , Ur     , Uu     , Uu^Br| , Uu^Br/ , Uh     , Uh     , Ur     , Xu     , Xu     , Uu     , Ur     , Uu     , Qxu    , Xu     , Qxu    , Qxu    , Qxu    , Qxu    , Qxu    , Qxu    , Xu     , Xu     , Xu     , Xu     , Wwy    , Wwy    , Xu     , Xu     , Xu     , Xu     , Xu     , Xu     , Xu     , Xu
Xu     , Xu     , Xu     , Woy    , Wwy    , Wwy    , Wwy    , Xu     , Wwy    , Wwfy   , Wwfy   , Xu     , Xu     , Uh     , Uu^Br| , Uu     , Uu     , Uh     , Ur     , Uu     , Uu     , Xu     , Xu     , Xu     , Qxu    , Qxu    , Qxu    , Qxu    , Xu     , Qxu    , Qxu    , Xu     , Xu     , Xu     , Xu     , Xu     , Wwy    , Wwfy   , Uh     , Xu     , Xu     , Xu     , Xu     , Xu     , Xu     , Xu
Xu     , Xu     , Xu     , Woy    , Woy    , Wwy    , Wwy    , Wwy    , Wwy    , Wwfy   , Xu     , Xu     , Xu     , Xu     , Uu^Br| , Uu     , Ur^Es  , Ur     , Uu     , Uu     , Qxu    , Xu     , Qxu    , Xu     , Qxu    , Qxu    , Qxu    , Xu     , Qxu    , Xu     , Qxu    , Qxu    , Xu     , Xu     , Xu     , Wwy    , Wwy    , Wwfy   , Uh     , Xu     , Xu     , Xu     , Xu     , Xu     , Xu     , Xu
Xu     , Xu     , Xu     , Xu     , Xu     , Xu     , Xu     , Xu     , Xu     , Xu     , Uh     , Uh     , Uu^Br/ , Uu^Br/ , Ur     , Ur     , Xu     , Uu     , Xu     , Xu     , Xu     , Qxu    , Qxu    , Qxu    , Qxu    , Qxu    , Qxu    , Qxu    , Xu     , Qxu    , Qxu    , Qxu    , Qxu    , Uh     , Wwy    , Wwy    , Wwy    , Wwfy   , Xu     , Qxu    , Qxu    , Xu     , Xu     , Xu     , Xu     , Xu
Xu     , Xu     , Xu     , Xu     , Xu     , Xu     , Xu     , Xu     , Uh     , Uh     , Uu^Br/ , Uu^Br/ , Uu^Br/ , Uu^Br| , Ur     , Xu     , Xu     , Xu     , Xu     , Xu     , Xu     , Xu     , Uu     , Qxu    , Uu     , Qxu    , Xu     , Qxu    , Xu     , Xu     , Xu     , Xu     , Xu     , Wwy    , Wwy    , Wwy    , Uh     , Xu     , Xu     , Xu     , Qxu    , Qxu    , Xu     , Xu     , Xu     , Xu
Xu     , Xu     , Xu     , Xu     , Xu     , Xu     , Uh     , Uh     , Uh     , Uh     , Uu     , Uu^Br/ , Uu^Br/ , Uu^Br| , Uu^Br\ , Ur     , Uu     , Xu     , Xu     , Xu     , Xu     , Xu     , Xu     , Uu^Vud , Xu     , Uu     , Xu     , Xu     , Xu     , Xu     , Xu     , Xu     , Wwy    , Wwy    , Wwfy   , Uh     , Uh     , Xu     , Xu     , Qxu    , Qxu    , Qxu    , Qxu    , Xu     , Xu     , Xu
Xu     , Xu     , Xu     , Xu     , Xu     , Xu     , Xu     , Uh     , Uh     , Uh     , Uh     , Uu     , Uh     , Uu^Vud , Uh     , Ur^Br\ , Uu^Br| , Uu^Vud , Xu     , Xu     , Xu     , Xu     , Xu     , Xu     , Xu     , Xu     , Xu     , Xu     , Xu     , Xu     , Xu     , Xu     , Wwy    , Wwy    , Uh     , Uh     , Qxu    , Qxu    , Qxu    , Qxu    , Qxu    , Qxu    , Xu     , Xu     , Xu     , Xu
Xu     , Xu     , Xu     , Xu     , Xu     , Xu     , Xu     , Xu     , Xu     , Uh     , Uh     , Uh     , Uh     , Uh     , Uh     , Ur     , Uu^Br| , Xu     , Ur     , Uu     , Uu     , Xu     , Xu     , Xu     , Xu     , Xu     , Wwy    , Wwy    , Wwy    , Wwy    , Woy    , Wwy    , Wwy    , Wwfy   , Xu     , Xu     , Qxu    , Qxu    , Qxu    , Qxu    , Qxu    , Qxu    , Qxu    , Qxu    , Xu     , Xu
Xu     , Xu     , Xu     , Xu     , Xu     , Xu     , Xu     , Xu     , Xu     , Xu     , Xu     , Uh     , Uh     , Uh     , Xu     , Ur     , Ur     , Ur^Br\ , Ur^Br\ , Uu^Vud , Rr     , Rr     , Cud    , Xu     , Wwfy   , Wwy    , Wwy    , Wwy    , Xu     , Wwy    , Wwy    , Wwy    , Xu     , Xu     , Xu     , Qxu    , Qxu    , Qxu    , Qxu    , Qxu    , Xu     , Qxu    , Qxu    , Qxu    , Qxu    , Xu
Xu     , Xu     , Xu     , Xu     , Xu     , Xu     , Xu     , Xu     , Xu     , Xu     , Xu     , Xu     , Xu     , Xu     , Rr     , Uu     , Uu     , Uu     , Uu     , Uu^Br\ , Uu     , Rr     , Rr     , Uu     , Wwfy   , Wwy    , Uh     , Xu     , Xu     , Xu     , Xu     , Xu     , Xu     , Xu     , Xu     , Xu     , Qxu    , Xu     , Cud    , Cud    , Cud    , Xu     , Xu     , Qxu    , Qxu    , Xu
Xu     , Xu     , Xu     , Xu     , Xu     , Xu     , Qxu    , Qxu    , Qxu    , Qxu    , Qxu    , Xu     , Xu     , Xu     , Xu     , Rr     , Cud    , Rr     , Uu     , Uu     , Uu^Vud , Rr     , Cud    , Uh     , Wwfy   , Wwy    , Uu     , Xu     , Xu     , Xu     , Xu     , Xu     , Xu     , Qxu    , Qxu    , Xu     , Qxu    , Xu     , Cud    , 3 Kud  , Cud    , Xu     , Qxu    , Qxu    , Xu     , Xu
Xu     , Xu     , Xu     , Xu     , Qxu    , Qxu    , Qxu    , Qxu    , Qxu    , Qxu    , Qxu    , Qxu    , Qxu    , Qxu    , Qxu    , Qxu    , Qxu^Bs/, Rr     , Cud    , Uu     , Rr     , Rr     , Rr     , Ur     , Wwfy   , Wwy    , Uh     , Uh     , Qxu    , Xu     , Qxu    , Xu     , Qxu    , Qxu    , Xu     , Qxu    , Qxu    , Qxu    , Xu     , Cud    , Xu     , Qxu    , Xu     , Qxu    , Xu     , Xu
Xu     , Xu     , Xu     , Xu     , Qxu    , Qxu    , Qxu    , Qxu    , Qxu    , Qxu    , Qxu    , Qxu    , Qxu    , Qxu    , Qxu^Bs/, Qxu^Bs/, Qxu    , Qxu    , Xu     , Rr     , Rr     , Rr     , Cud    , Uu     , Wwfy   , Wwy    , Uh     , Uh     , Qxu    , Qxu    , Qxu    , Qxu    , Xu     , Qxu    , Qxu    , Qxu    , Qxu    , Qxu    , Qxu    , Xu     , Qxu    , Qxu    , Xu     , Xu     , Xu     , Xu
Xu     , Xu     , Xu     , Xu     , Qxu    , Qxu    , Qxu    , Qxu    , Uu     , Uu     , Uu     , Uu     , Uu     , Qxu^Bs/, Qxu    , Qxu    , Qxu    , Qxu    , Qxu    , Xu     , Xu     , Rr     , Xu     , Xu     , Wwy    , Wwy    , Xu     , Xu     , Xu     , Qxu    , Xu     , Qxu    , Qxu    , Qxu    , Qxu    , Xu     , Qxu    , Qxu    , Qxu    , Qxu    , Qxu    , Qxu    , Qxu    , Xu     , Xu     , Xu
Xu     , Xu     , Xu     , Xu     , Xu     , Qxu    , Qxu    , Qxu    , Uu     , Uu^Vud , Uu     , Uu     , Uu     , Uu     , Qxu    , Qxu    , Qxu    , Qxu    , Xu     , Xu     , Xu     , Xu     , Xu     , Xu     , Wwy    , Wwy    , Xu     , Xu     , Xu     , Qxu    , Qxu    , Xu     , Qxu    , Xu     , Xu     , Xu     , Qxu    , Qxu    , Qxu    , Xu     , Qxu    , Xu     , Qxu    , Xu     , Xu     , Xu
Xu     , Xu     , Xu     , Xu     , Xu     , Xu     , Qxu    , Qxu    , Uu     , Uu     , Uu     , Uu     , Qxu    , Xu     , Qxu    , Qxu    , Xu     , Xu     , Xu     , Xu     , Xu     , Xu     , Wwy    , Wwy    , Wwy    , Wwy    , Xu     , Xu     , Xu     , Xu     , Xu     , Qxu    , Xu     , Xu     , Xu     , Xu     , Qxu    , Xu     , Qxu    , Qxu    , Qxu    , Qxu    , Xu     , Xu     , Xu     , Xu
Xu     , Xu     , Xu     , Xu     , Xu     , Xu     , Xu     , Qxu    , Qxu    , Uu     , Xu     , Uu     , Qxu    , Qxu    , Qxu    , Xu     , Xu     , Xu     , Xu     , Xu     , Wwy    , Wwy    , Wwy    , Wwy    , Uh     , Xu     , Uh     , Xu     , Qxu    , Xu     , Xu     , Qxu    , Qxu    , Qxu    , Qxu    , Qxu    , Xu     , Qxu    , Xu     , Xu     , Xu     , Xu     , Xu     , Xu     , Xu     , Xu
Xu     , Xu     , Xu     , Xu     , Xu     , Xu     , Xu     , Qxu    , Qxu    , Qxu    , Uu     , Uu     , Qxu    , Qxu    , Xu     , Xu     , Xu     , Xu     , Uh     , Wwy    , Wwy    , Wwy    , Xu     , Xu     , Xu     , Uh     , Xu     , Qxu    , Qxu    , Qxu    , Qxu    , Qxu    , Qxu    , Xu     , Qxu    , Qxu    , Xu     , Xu     , Xu     , Xu     , Xu     , Xu     , Xu     , Xu     , Xu     , Xu
Xu     , Xu     , Xu     , Xu     , Uu     , Ur     , Ur     , Uu     , Uu     , Uu     , Ur^Es  , Ur     , Uu     , Xu     , Xu     , Xu     , Woy    , Woy    , Uh     , Uh     , Uh     , Xu     , Xu     , Xu     , Xu     , Xu     , Xu     , Xu     , Xu     , Qxu    , Qxu    , Qxu    , Qxu    , Qxu    , Xu     , Qxu    , Xu     , Xu     , Xu     , Xu     , Xu     , Xu     , Xu     , Xu     , Xu     , Xu
Xu     , Xu     , Xu     , Xu     , Uu     , Uu     , Uu     , Ur^Es  , Uu     , Ur     , Uu     , Uu^Vu  , Uh     , Xu     , Xu     , Xu     , Uh     , Uh     , Uh     , Uh     , Uh     , Woy    , Woy    , Xu     , Xu     , Xu     , Xu     , Xu     , Xu     , Xu     , Xu     , Qxu    , Xu     , Xu     , Xu     , Xu     , Xu     , Xu     , Xu     , Xu     , Xu     , Xu     , Xu     , Xu     , Xu     , Xu
Xu     , Xu     , Xu     , Xu     , Xu     , Ur     , Ur     , Uu     , Uu     , Uu     , Ur     , Ur     , Xu     , Xu     , Xu     , Uh     , Uh     , Uh     , Uh     , Uh     , Uh     , Uh     , Uh     , Xu     , Xu     , Xu     , Xu     , Xu     , Xu     , Xu     , Xu     , Xu     , Xu     , Xu     , Xu     , Xu     , Xu     , Xu     , Xu     , Xu     , Xu     , Xu     , Xu     , Xu     , Xu     , Xu
Xu     , Xu     , Xu     , Xu     , Xu     , Uu     , Uu^Vu  , Ur     , Uu     , Ur     , Uu     , Xu     , Xu     , Xu     , Xu     , Woy    , Woy    , Uh     , Uh     , Uh     , Uh     , Uh     , Woy    , Xu     , Xu     , Xu     , Xu     , Xu     , Xu     , Xu     , Xu     , Xu     , Xu     , Xu     , Xu     , Xu     , Xu     , Xu     , Xu     , Xu     , Xu     , Xu     , Xu     , Xu     , Xu     , Xu
Xu     , Xu     , Xu     , Xu     , Xu     , Ur     , Ur^Es  , Uu     , Uu     , Uu^Es  , Ur     , Ur     , Xu     , Xu     , Xu     , Xu     , Xu     , Woy    , Woy    , Uh     , Woy    , Woy    , Xu     , Xu     , Xu     , Xu     , Xu     , Xu     , Xu     , Xu     , Xu     , Xu     , Xu     , Xu     , Xu     , Xu     , Xu     , Xu     , Xu     , Xu     , Xu     , Xu     , Xu     , Xu     , Xu     , Xu
Xu     , Xu     , Xu     , Xu     , Xu     , Xu     , Xu     , Ur     , Uh     , Ur     , Xu     , Xu     , Xu     , Xu     , Xu     , Xu     , Xu     , Xu     , Xu     , Xu     , Xu     , Xu     , Xu     , Xu     , Xu     , Xu     , Xu     , Xu     , Xu     , Xu     , Xu     , Xu     , Xu     , Xu     , Xu     , Xu     , Xu     , Xu     , Xu     , Xu     , Xu     , Xu     , Xu     , Xu     , Xu     , Xu
Xu     , Xu     , Xu     , Xu     , Xu     , Xu     , Xu     , Uh     , Uh     , Uu     , Xu     , Xu     , Xu     , Xu     , Xu     , Xu     , Xu     , Xu     , Xu     , Xu     , Xu     , Xu     , Xu     , Xu     , Xu     , Xu     , Xu     , Xu     , Xu     , Xu     , Xu     , Xu     , Xu     , Xu     , Xu     , Xu     , Xu     , Xu     , Xu     , Xu     , Xu     , Xu     , Xu     , Xu     , Xu     , Xu
Xu     , Xu     , Xu     , Xu     , Xu     , Xu     , Xu     , Uh     , Uh     , Xu     , Xu     , Xu     , Xu     , Xu     , Xu     , Xu     , Xu     , Xu     , Xu     , Xu     , Xu     , Xu     , Xu     , Xu     , Xu     , Xu     , Xu     , Xu     , Xu     , Xu     , Xu     , Xu     , Xu     , Xu     , Xu     , Xu     , Xu     , Xu     , Xu     , Xu     , Xu     , Xu     , Xu     , Xu     , Xu     , Xu
Xu     , Xu     , Xu     , Xu     , Xu     , Xu     , Xu     , Xu     , Uu     , Xu     , Xu     , Xu     , Xu     , Xu     , Xu     , Xu     , Xu     , Xu     , Xu     , Xu     , Xu     , Xu     , Xu     , Xu     , Xu     , Xu     , Xu     , Xu     , Xu     , Xu     , Xu     , Xu     , Xu     , Xu     , Xu     , Xu     , Xu     , Xu     , Xu     , Xu     , Xu     , Xu     , Xu     , Xu     , Xu     , Xu
