border_size=1
usage=map

Ms     , Ms     , Ms     , Ms     , Ms     , Ms     , Ms     , Ms     , Ms     , Ms     , Ms     , Ms     , Ms     , Ms     , Ms     , Ms     , Ms     , Ms     , Ms     , Ms     , Ms     , Ms     , Ms     , Ms     , Ha^Fpa , Ha     , Ha     , Ha     , Ha     , Ha     , Ha     , Ha     , Ha     , Ha     , Ha     , Ha     , Ha     , Ha^Fpa , Ha^Fpa , Ha^Fpa , Ha^Fpa , Ha^Fpa , Ha     , Ha     , Hhd    , Ha     , Hhd    , Hhd    , Ch     , Hhd
Ms     , Ms     , Ms     , Ms     , Ms     , Ms     , Ms     , Ms     , Ms     , Ms     , Ms     , Ms     , Ms     , Ms     , Ms     , Ms     , Ms     , Ms     , Ms     , Ms     , Ms     , Ms     , Ms     , Ha     , Hhd    , Ha     , Hhd    , Hhd    , Hhd    , Ha     , Hhd    , Hhd    , Hhd    , Ha     , Hhd    , Ha     , Hhd    , Ha     , Hhd^Fp , Hhd^Fp , Hhd^Fp , Hhd    , Hhd^Vhh, Hhd    , Hhd    , Hhd    , Ch     , Ch     , Ch     , Ch
Ms     , Ms     , Ms     , Ms     , Ms     , Ms     , Ms     , Ms     , Ha^Fpa , Ha^Fpa , Ha     , Ms     , Ms     , Ms     , Ha     , Ha^Fpa , Ha     , Ms     , Ms     , Ms     , Ha     , Ha     , Ha     , Ha     , Hhd    , Hhd    , Ha     , Hhd    , Hhd    , Hhd    , Ha     , Hhd    , Hhd    , Hhd    , Hhd    , Hhd    , Hhd    , Hhd    , Hhd    , Hhd    , Hhd    , Hhd    , Hhd    , Hhd    , Ch     , Ch     , Ch     , Ch     , Ch     , Ch
Ms     , Ms     , Ha     , Ms     , Ms     , Ms     , Ms     , Ms     , Ha     , Ha^Vyb , Ha     , Ms     , Ha     , Ms     , Ha     , Ha     , Ha     , Ha     , Ha     , Ms     , Ha     , Hhd^Fdw, Hhd    , Hhd    , Hhd    , Hhd    , Hhd    , Hhd    , Hhd^Fmw, Hhd    , Hhd    , Hhd    , Hhd    , Hhd^Vhh, Hhd    , Hhd    , Hhd    , Hhd    , Hhd    , Hhd    , Hhd    , Hhd    , Hhd    , Hhd    , Ch     , Ch     , Ch     , Ch     , Kh     , Ch
Ms     , Ms     , Ms     , Ms     , Ms     , Ms     , Ms     , Ms     , Ms     , Ha     , Ha     , Ha     , Ha     , Ha     , Ha     , Ha     , Hhd    , Aa     , Hhd    , Ha     , Hhd    , Hhd    , Hhd    , Hhd    , Ha     , Hhd    , Hhd    , Hhd    , Hhd    , Hhd    , Hhd    , Hhd    , Hhd    , Hhd    , Gd     , Hhd    , Hhd    , Hhd    , Hhd    , Hhd    , Hhd    , Hhd^Vhh, Hhd    , Hhd    , Ch     , Ch     , Ch     , Kh     , 2 Kh   , Kh
Ms     , Ms     , Ms     , Ms     , Ms     , Ms     , Ms     , Ms     , Ha     , Ha     , Hhd    , Hhd    , Hhd    , Hhd    , Hhd    , Hhd    , Hhd^Fmw, Hhd    , Ha     , Hhd    , Hhd    , Hhd    , Hhd    , Hhd    , Hhd    , Hhd    , Hhd    , Hhd    , Hhd    , Hhd    , Hhd    , Hhd^Es , Hhd    , Gd     , Hhd    , Hhd    , Hhd    , Hhd    , Hhd    , Hhd    , Hhd    , Hhd    , Hhd    , Hhd    , Ch     , Ch     , Ch     , Kh     , Kh     , Kh
Ha     , Ms     , Ms     , Ms     , Ms     , Ms     , Ha^Fma , Ms     , Ha     , Hhd    , Ha     , Ha     , Ha     , Hhd    , Hhd    , Hhd    , Hhd    , Ha     , Hhd    , Hhd    , Hhd    , Hhd    , Hhd    , Hhd    , Hhd    , Hhd    , Hhd    , Hhd    , Hhd    , Hhd    , Hhd    , Hhd    , Hhd    , Hhd    , Hhd    , Hhd    , Hhd^Fmw, Hhd    , Hhd    , Hhd    , Hhd    , Hhd    , Hhd    , Hhd    , Ch     , Ch     , Ch     , Ch     , Ch     , Ch
Ha     , Ha     , Ms     , Ms     , Ms     , Ha^Fma , Hhd^Fmw, Ha^Fma , Hhd^Fmw, Hhd    , Hhd    , Hhd    , Hhd    , Hhd    , Hhd    , Hhd    , Hhd    , Hhd    , Hhd^Vyb, Hhd^Dr , Hhd    , Hhd    , Hhd    , Hhd    , Hhd    , Hhd^Fmw, Hhd    , Gd     , Hhd    , Hhd    , Hhd    , Hhd    , Hhd    , Hhd    , Hhd    , Hhd    , Hhd    , Hhd    , Hhd    , Hhd    , Hhd    , Gd     , Hhd    , Hhd    , Hhd    , Ch     , Ch     , Ch     , Ch     , Ch
Hhd    , Ha     , Ha     , Ha     , Ha     , Ha^Fma , Hhd^Fmw, Hhd^Fmw, Hhd    , Hhd    , Hhd    , Hhd    , Hhd    , Hhd    , Hhd    , Hhd    , Hhd    , Hhd    , Hhd    , Hhd    , Hhd    , Hhd    , Hhd    , Re     , Re     , Hhd    , Hhd    , Hhd    , Hhd^Dr , Hhd    , Hhd    , Gd     , Hhd    , Hhd    , Gd^Vh  , Hhd    , Gd     , Hhd    , Gd^Es  , Hhd    , Hhd    , Hhd    , Hhd    , Hhd^Vhh, Hhd    , Hhd    , Gd     , Ch     , Ch     , Ch
Ha     , Hhd    , Hhd    , Hhd    , Hhd    , Hhd    , Hhd    , Hhd^Fmw, Hhd    , Hhd    , Hhd    , Hhd    , Hhd    , Hhd    , Hhd    , Hhd    , Hhd^Vhh, Hhd    , Hhd    , Hhd    , Hhd    , Hhd    , Hhd    , Re     , Xos    , Hhd^Dr , Hhd    , Hhd^Vhh, Hhd    , Hhd    , Ch     , Hhd    , Hhd^Dr , Gd     , Gd     , Gd     , Rd     , Gd     , Gd     , Hhd^Vhh, Hhd    , Hhd    , Hhd    , Hhd    , Hhd    , Hhd    , Gd     , Gd     , Rd     , Rd
Hhd    , Hhd    , Hhd    , Hhd    , Hhd    , Hhd    , Hhd    , Hhd    , Hhd    , Hhd    , Hhd    , Hhd^Fmw, Hhd    , Hhd    , Hhd    , Hhd    , Hhd    , Hhd    , Hhd    , Hhd    , Hhd    , Re^Dr  , Re     , Xos    , Xos    , Xos    , Xos    , Re     , Re^Dr  , Ch     , Ch     , Ch     , Ch     , Gd^Dr  , Rd     , Rd     , Rd     , Rd     , Rd     , Gd     , Gd     , Gd     , Gd     , Gd^Fp  , Gd     , Gd     , Rd     , Rd     , Rd     , Rd
Hhd    , Hhd    , Hhd    , Hhd    , Hhd    , Hhd    , Hhd    , Hhd    , Hhd    , Hhd    , Hhd    , Gd     , Hhd    , Hhd    , Gd     , Gd     , Hhd    , Hhd    , Hhd    , Gd     , Hhd    , Hhd    , Gd     , Ai     , Ai     , Xos    , Xos    , Xos    , Xos    , Ch     , Ch     , Ch     , Ch     , Ch     , Ch     , Rd     , Gd     , Rd     , Rd     , Rd     , Rd     , Gd     , Gd     , Gd     , Rd     , Rd     , Rd     , Rd     , Gd     , Gd
Hhd    , Hhd    , Ds     , Gd^Es  , Gd     , Hhd    , Gd     , Hhd    , Gd^Vh  , Hhd    , Gd     , Hhd    , Hhd    , Hhd    , Ds     , Ds     , Ds     , Hhd    , Gd     , Hhd    , Gd     , Gd^Vh  , Ai     , Ai     , Ai     , Ai     , Ai     , Xos    , Xos    , Xos    , Xos    , Ch     , Ch     , 4 Kh   , Ch     , Gd     , Gd     , Gd     , Gd     , Rd     , Rd     , Rd     , Rd     , Rd     , Rd     , Rd     , Gd     , Gd     , Gd^Vh  , Gd
Ds     , Ds     , Ai     , Ai     , Ww     , Gd     , Ww     , Gd     , Ai     , Ai     , Ww     , Gd     , Ai     , Gd     , Ai     , Ai     , Ai     , Ds     , Ds     , Ds     , Ai     , Ai     , Ai     , Ww     , Ai     , Ai     , Ai     , Ai     , Ai     , Xos    , Xos    , Xos    , Ch     , Ch     , Ch     , Hhd    , Gd^Fp  , Gd     , Gd     , Gd     , Gd     , Rd     , Rd^Es  , Rd     , Gd     , Gd     , Gd     , Gd     , Gd     , Gd
Ai     , Ai     , Ww     , Ww     , Ww     , Ww     , Ww     , Ww     , Ww     , Ww     , Ww     , Ww     , Ww     , Ww     , Ww     , Ww     , Ww     , Ai     , Ai     , Ai     , Ai     , Ai     , Ww     , Ww     , Ai     , Ai     , Wo     , Ai     , Ai     , Xos    , Xos    , Xos    , Ch     , Ch     , Ch     , Hhd    , Hhd    , Hhd    , Gd     , Gd     , Gd     , Gd     , Gd     , Gd     , Gd^Gvs , Gd     , Gd^Vh  , Gd     , Gd^Vh  , Gd
Ww     , Ww     , Ww     , Ww^Vm  , Ww     , Ww     , Ww     , Ww     , Ww     , Ww     , Ww     , Ww     , Ww     , Ww     , Ww     , Ww     , Ww^Vm  , Ww     , Ww     , Ww     , Ww     , Ww     , Ww     , Ww     , Ai     , Ai     , Ai     , Ai     , Ai     , Xos    , Xos    , Xos    , Ch     , Ch     , Ch     , Hhd    , Hhd    , Gd^Vh  , Gd     , Gd     , Gd     , Gd     , Gd^Gvs , Re^Gvs , Re^Gvs , Re^Gvs , Gd     , Gd     , Gd     , Gd
Ww     , Ww     , Ww     , Ww     , Ww     , Ww     , Ww     , Ww     , Ww     , Ww     , Ww     , Ww     , Wo     , Ww     , Wo     , Wo     , Wo     , Ww     , Wo     , Ww     , Wo     , Wo     , Wo     , Wo     , Wo     , Ai     , Ai     , Ai     , Ai     , Xos    , Xos    , Xos    , Ch     , Ch     , Hhd    , Hhd    , Hhd    , Hhd    , Gd     , Gd     , Gd     , Gd     , Gd     , Re^Gvs , Gd     , Gd     , Gd     , Gd     , Gd     , Gd
Ww     , Ww     , Ww     , Ww     , Ww     , Ww     , Ww     , Ww     , Ww     , Ww     , Ww     , Wo     , Wo     , Wo     , Wo     , Wo     , Wo     , Wo     , Wo     , Wo     , Wo     , Wo     , Wo     , Wo     , Wo     , Ai     , Ai     , Ai     , Ai     , Xos    , Xos    , Xos    , Re     , Re     , Re^Es  , Hhd    , Hhd    , Hhd    , Re     , Re     , Re     , Gd     , Re     , Gd     , Re     , Ss     , Ss     , Gd     , Gd     , Gd^Es
Ww     , Ww     , Ww     , Ww     , Ww     , Ww     , Ww     , Ww     , Ww     , Ww     , Wo     , Wo     , Wo     , Wo     , Wo     , Wo     , Wo     , Wo     , Wo     , Wo     , Wo     , Wo     , Wo     , Wo     , Wo     , Wo     , Ai     , Ai     , Ai     , Xos    , Xos    , Xos    , Re^Dr  , Re     , Re     , Hhd    , Re     , Gd^Fdw , Re     , Re     , Ai     , Re     , Wwf    , Re     , Ai     , Ai     , Ai     , Gd     , Ai^Bw| , Gd
Ww     , Ww     , Ww     , Ww     , Ww     , Ww     , Ww     , Ww     , Ww     , Ww     , Wo     , Wo     , Wo     , Wo     , Wo     , Wo     , Wo     , Wo     , Wo     , Wo     , Wo     , Wo     , Wo     , Wo     , Wo     , Wo     , Ai     , Ai     , Ai     , Xos    , Xos    , Xos    , Ai     , Re     , Ai     , Re     , Ai     , Re     , Ai     , Ai     , Ww     , Wwf    , Ww     , Wwf    , Ww     , Ww     , Ww     , Ai     , Ww^Bw| , Ai
Ww     , Ww     , Ww^Vm  , Ww     , Ww     , Ww     , Ww     , Ww     , Ww     , Ww     , Wo     , Wo     , Wo     , Wo     , Wo     , Wo     , Wo     , Wo     , Wo     , Wo     , Wo     , Wo     , Wo     , Wo     , Wo     , Wo     , Ai     , Ai     , Ai     , Xos    , Xos    , Ch     , Wwr    , Ai     , Ww     , Ai     , Ww     , Ww     , Ww     , Ww     , Ww     , Ww     , Ww     , Ww     , Ww     , Ww     , Ww     , Ww     , Ww^Bw| , Ww
Ww     , Ww     , Ww     , Ww     , Ww     , Ww     , Ww     , Ww     , Ww^Vm  , Ww     , Ww     , Wo     , Wo     , Wo     , Ww     , Wo     , Ww     , Wo     , Wo     , Wo     , Wo     , Wo     , Wo     , Wo     , Wo     , Wo     , Wo     , Ai     , Ai     , Ch     , Ch     , Ch     , Ai     , Ww     , Ww     , Ww     , Ww     , Ww     , Wo     , Wo     , Wo     , Ww     , Wo     , Ww     , Ww     , Ww     , Ww     , Ww     , Ww     , Ww
Ww     , Ww     , Ww     , Ww     , Ww     , Ww     , Ww     , Ww     , Ww     , Ww     , Ww     , Ww     , Ww     , Ww     , Ww     , Ww     , Ww     , Ww     , Ww     , Wo     , Wo     , Wo     , Wo     , Wo     , Wo     , Wo     , Ai     , Wo     , Ai     , Ch     , Ch     , Xos    , Wwr    , Wwr    , Ww     , Ww     , Ww     , Ww     , Ww     , Ww     , Ww     , Wo     , Wo     , Ww     , Ww     , Ww     , Ww     , Ww     , Ww     , Ww
Ww     , Ww     , Ww     , Ww     , Ww     , Ww     , Ww     , Ww     , Ww     , Ww     , Ww     , Ww     , Ww     , Ww     , Ww     , Ww     , Ww     , Ww     , Ww     , Ww     , Wo     , Wo     , Wo     , Wo     , Wo     , Wo     , Ai     , Ai     , Ai     , Ch     , Xos    , Ch     , Ai     , Ai     , Ai     , Ww     , Ww     , Ww     , Ww     , Ww     , Ww     , Ww     , Ww     , Wo     , Ww     , Ww     , Ww     , Ww     , Ww     , Ww
Ai     , Ww     , Ww     , Ww     , Gd     , Ww     , Ai     , Ww     , Gd     , Ww     , Gd     , Ai     , Ai     , Ai     , Ds     , Ww     , Ai     , Ww     , Ww     , Ww     , Ww     , Wo     , Wo     , Wo     , Wo     , Ai     , Ai     , Ai     , Ai     , Xos    , Xos    , Ch     , Re     , Re     , Re     , Ai     , Ai     , Ai     , Ai     , Ai     , Ai     , Ww     , Ai     , Ww     , Wwf    , Ww     , Wwf    , Ww     , Ww     , Ww
Hhd    , Hhd    , Hhd    , Gd^Vh  , Hhd    , Hhd    , Hhd    , Hhd    , Hhd    , Gd     , Hhd    , Hhd    , Hhd    , Gd     , Hhd    , Ds     , Ai     , Ai     , Ww     , Ww     , Ww     , Ww     , Ww     , Ww     , Ww     , Ai     , Ai     , Ai     , Ai     , Xos    , Xos    , Xos    , Re^Dr  , Re     , Re     , Ai     , Ai     , Ai     , Re     , Re     , Re     , Ai     , Ai     , Wwf    , Ai     , Wwf    , Ai     , Wwf    , Ww     , Ww
Hhd    , Hhd    , Hhd    , Hhd    , Hhd^Fmw, Hhd    , Hhd    , Hhd    , Hhd    , Hhd    , Hhd    , Hhd^Fdw, Hhd    , Hhd    , Hhd    , Ds     , Ds     , Ai     , Ai     , Ww     , Ww     , Ww     , Ww^Vm  , Ww     , Ai     , Ai     , Wo     , Ai     , Ai     , Xos    , Xos    , Xos    , Ch     , Ch     , Ch     , Re     , Re     , Re     , Hhd    , Hhd    , Hhd    , Re     , Re     , Ai     , Gd     , Gd     , Gd     , Ai     , Ss     , Ss
Hhd    , Hhd    , Hhd    , Hhd    , Hhd    , Hhd    , Hhd    , Hhd    , Hhd    , Hhd^Vyb, Hhd^Dr , Hhd    , Hhd    , Hhd    , Hhd    , Hhd    , Ds     , Ai     , Ai     , Ai     , Ww     , Ww     , Ww     , Ww     , Ai     , Ww     , Ai     , Ai     , Ai     , Xos    , Xos    , Xos    , Ch     , Ch     , Ch     , Re     , Re     , Gd^Vh  , Hhd    , Hhd    , Hhd    , Hhd    , Hhd    , Gd     , Gd     , Gd     , Gd     , Gd^Fmw , Rd     , Rd
Hhd    , Hhd    , Hhd    , Ce     , Hhd    , Hhd    , Hhd    , Hhd    , Hhd    , Hhd    , Hhd    , Hhd    , Gd     , Hhd    , Hhd^Fdw, Hhd    , Hhd    , Ds     , Hhd    , Ai     , Ai     , Ai     , Ai     , Ai     , Ai     , Ai     , Ai     , Ai     , Ai     , Xos    , Xos    , Xos    , Ch     , Ch     , Ch     , Hhd    , Hhd    , Hhd    , Gd^Fp  , Hhd    , Hhd    , Hhd    , Hhd    , Gd^Vh  , Gd     , Gd     , Rd     , Rd     , Rd     , Rd
Ha     , Hhd    , Ce     , Ce     , Ce     , Hhd    , Gd     , Hhd    , Hhd    , Hhd    , Hhd    , Gd     , Hhd    , Hhd    , Hhd    , Hhd    , Hhd    , Hhd    , Hhd    , Gd     , Gd     , Ai     , Ai     , Ai     , Ai     , Ai     , Ai     , Ai     , Xos    , Xos    , Xos    , Xos    , Ch     , Ch     , Ch     , Hhd    , Gd     , Hhd    , Rd     , Rd     , Rd     , Gd     , Gd     , Gd     , Rd     , Rd     , Rd     , Rd     , Gd     , Gd
Ha     , Ce     , Ha     , 1 Ke   , Ha     , Ce     , Hhd    , Gd     , Hhd^Vhh, Hhd    , Hhd^Fmw, Hhd    , Hhd    , Gd     , Gd     , Hhd    , Hhd^Fmw, Hhd    , Hhd    , Gd     , Hhd    , Gd     , Re     , Ai     , Re     , Ai     , Xos    , Xos    , Xos    , Xos    , Ch     , Ch     , Ch     , 3 Kh   , Ch     , Gd     , Rd     , Rd     , Rd     , Rd^Es  , Rd     , Rd     , Rd     , Rd     , Rd     , Rd     , Gd     , Gd     , Hhd    , Gd
Ha     , Ha     , Ms     , Ha     , Ms     , Ha     , Hhd    , Hhd    , Hhd    , Hhd    , Hhd    , Hhd    , Hhd    , Hhd    , Hhd    , Hhd    , Hhd    , Hhd    , Hhd    , Hhd    , Gd^Es  , Re     , Re^Dr  , Re     , Xos    , Xos    , Xos    , Xos    , Aa     , Ch     , Ch     , Ch     , Ch     , Ch     , Rd     , Rd     , Rd     , Rd     , Gd     , Gd     , Gd     , Rd     , Rd     , Rd     , Gd     , Gd     , Gd     , Gd^Dr  , Hhd^Vyb, Hhd
Ms     , Ha     , Ms     , Ms     , Ms     , Ha     , Ha     , Ha     , Ha     , Hhd    , Hhd    , Hhd    , Ha     , Hhd    , Hhd    , Hhd    , Hhd    , Hhd    , Hhd    , Hhd    , Ha     , Aa     , Aa     , Aa     , Aa     , Xos    , Aa     , Aa^Dr  , Aa     , Ch     , Ch     , Ch     , Aa     , Rd     , Aa     , Rd     , Aa     , Aa     , Hhd    , Gd^Vh  , Hhd    , Gd     , Aa     , Aa     , Hhd    , Gd     , Hhd    , Hhd    , Hhd    , Hhd
Ms     , Ms     , Ms     , Ms     , Ms^Vhha, Ms     , Ms     , Ms     , Ha^Fpa , Ha     , Ha^Fda , Hhd    , Hhd    , Hhd    , Ha     , Hhd    , Ha     , Aa     , Ha     , Ha     , Ha     , Ha^Vyb , Ha     , Aa     , Ha     , Aa     , Ha     , Ha     , Ms^Vhha, Ms     , Ms     , Ha     , Ha     , Aa     , Aa^Fda , Aa     , Ms     , Ha     , Ha     , Ha     , Ha     , Aa^Fda , Ha     , Ha     , Ha     , Hhd    , Hhd    , Hhd    , Hhd    , Hhd
Ms     , Ms     , Ms     , Ms     , Ms     , Ms     , Ms     , Ms     , Ms     , Ha     , Ha     , Ha     , Ha     , Ha     , Ha     , Ha     , Ha     , Ha     , Ha     , Ha^Vhha, Ha     , Ha     , Ha     , Ha     , Ha     , Ha     , Ms     , Ms     , Ms     , Ms     , Ms     , Ms     , Ms     , Ha     , Ms     , Ms     , Ms     , Ms     , Ms     , Ha     , Ha     , Ms     , Ms     , Ms     , Ha     , Ha     , Hhd    , Hhd    , Hhd    , Hhd
Ms     , Ms     , Ms     , Ms     , Ms     , Ms     , Ms     , Ms     , Ms     , Ha     , Ha     , Aa     , Ha     , Ha     , Ha     , Ha     , Ha     , Ha     , Ha     , Ha     , Ha     , Ha     , Ha     , Ha     , Ha     , Ha     , Ms     , Ms     , Ms     , Ms     , Ms     , Ms     , Ms     , Ms     , Ms     , Ms     , Ms     , Ms     , Ms     , Ha     , Ha     , Ms     , Ms     , Ms     , Ha     , Ha     , Ha     , Ha     , Hhd    , Hhd
Ms     , Ms     , Ms     , Ms     , Ms     , Ms     , Ms     , Ms     , Ms     , Ms     , Ha     , Ha     , Ms     , Ha     , Ms     , Ms     , Ms     , Ha     , Ms     , Ha     , Ms     , Ha     , Ha     , Ha     , Ms     , Ms     , Ms     , Ms     , Ms     , Ms     , Ms     , Ms     , Ms     , Ms     , Ms     , Ms     , Ms     , Ms     , Ms     , Ms     , Ms     , Ms     , Ms     , Ms     , Ms     , Ms     , Ms     , Ha     , Ha     , Hhd
Ms     , Ms     , Ms     , Ms     , Ms     , Ms     , Ms     , Ms     , Ms     , Ms     , Ms     , Ms     , Ms     , Ms     , Ms     , Ms     , Ms     , Ms     , Ms     , Ms     , Ms     , Ms     , Ms     , Ms     , Ms     , Ms     , Ms     , Ms     , Ms     , Ms     , Ms     , Ms     , Ms     , Ms     , Ms     , Ms     , Ms     , Ms     , Ms     , Ms     , Ms     , Ms     , Ms     , Ms     , Ms     , Ms     , Ms     , Ha     , Ha     , Ha
